abă	bras
abĭ	ou bien
abí	ou bien
abi	n'est-ce pas
abí	n'est ce pas
ablă	galette haricots
ablŏ	maïs
ablóò	maïs fermenté
ablù	obscurité
abɔhàn	bière
abɔkún	graine
abɔkwín	graine
abɔyiya	récolte
abɛsánwùn	bénédiction du sacrement
acakpòdji	cercle de discussion
acéjí	le quivive
acíayŏ	menthe
acídikwín	balisier
acídikwínma	balisier
acídikwíntín	balisier
acívi	cuillère
acúglὲnzĭn	cricétome
acúkpá	perroquet
acuta	friperie
acɔcì	langouste
acɔnkwín	c'est bien fait
acɔnkwín	tant pis
acɔyíbì	uniforme
acɛgbè	autorité
acɛgbigbà	faute
acɛgbigbà	péché
acɛkpikpà	règne
acɛkpikpà	pouvoir
adadò	latrines
adagbigbò	circoncision
adagli	largeur
adaká	méchanceté extrême
adăn	colère
adăn	fureur
adàngbómɛ	malheur
adàngbómɛ	détresse
adánmácyó	félicitations
adánmácyó	remerciements
adànwìwá	grondements
adawé	bambou
adawetín	bambou
adaɖé	moitié
adiì	mais
adiì	mais hélas
adimáxwé	criquet
adimúlà	très
adĭnbèsé	grenouille rainette
adingbàn	mensonge
adingbàn	calomnie
aditì	géant
aditì	impressionnant
adlà	monstre
adlà	malheur
adlají	successivement
adlokpò	margouillat
adò	peur
adodò	résignation
adodwé	authentique
adohùhù	peur
adohùhù	effroi
adohùhù	angoisse
adohuhu	inquiétude
adohuhu	angoisse
adohuhu	effroi
adohuhu	peur
adohumɛ	peur
adohumɛ	effroi
adohumɛ	angoisse
adŭn	saleté
adùngbígbò	malpropreté
adùngbígbò	malpropre
adɔgbó	estomac
adɔgbugbó	audace
adɔgò	ventre
adɔkpá	flanc
adɔndundɔn	rivalité
adɔsúsú	hoquet
adɔzán	natte nuit
afafà	eventail
aféfé	couleur bleue
afínétì	epingle
aflété	brochet
afluflwì	chauve-souris
afú	brimade
afù	aubaine
afútámɛ	brimade
afyankú	hippotrague
afyɔnxocí	amulette
afɔdenyidò	faux pas
afɔdò	empreinte
afɔdógbè	adultère
afɔfún	poils des jambes
afɔgà	enjambée
afɔgblăgblă	croc-en-jambe
afɔgódwé	chaussette
afɔgólì	coude-pied
afɔgólì	cheville
afɔgúdo	cheville
afɔkpà	chaussure
afɔkpà	soulier
afɔkpà	sandale
afɔkpà	pantoufle
afɔkpadò	empreinte chaussure
afɔkpagàn	eperon
afɔkpákpá	semelle
afɔkpákpá	plante des pieds
afɔkpákpájí	sur la plante des pieds
afɔkpasúnsúnnú	brosse à chaussure
afɔkpasúnsúnnú	essuie-pieds
afɔkú	echec
afɔkú	défaveur
afɔkú	disgrâce
afɔsú	orteil
afɔtínxú	péroné
afɔtuntè	résistance
afɔtuntè	décision
afɔví	orteil
afɔɖiɖè	enjambée
afɔɖiɖè	pas
agà	en haut
agàlìlè	débauche
agadá	plaie
agadá	prodigue
aganmà	caméléon
agàsá	crabe
agàságò	crabe
agàságò	cadenas
agaví	enfant adultérin
agaví	bâtard
agbadé	maïs
agbajá	civière
agbajá	cartouchière
agbají	véranda
agbají	cour intérieure
agbăkò	malheur
agbăkò	imprévu
agbàlyá	fonte
agbàlyákwín	boulet
agbàn	bagage
agbàn	colis
agbàn	fardeau
agbàn	affaires
agbàn	marchandise
agbàn	matériel
agbanhɛnnú	porte-bagages
agbanhɛntín	poteau
agbanhɛntín	poutre
agbanɖuɖù	festin
agbanɖuɖù	noce
agbasá	véranda
agbawungbà	ostensiblement
agbawungbà	publiquement
agbayikún	graine maïs
agbáɖá	boubou
agbè	ecureuil
agbégì	menuisier
agbetawoyó	mer
agbetè	hyène
agbidì	terre noire
agbigbì	sorte nuit
agbĭn	sorte escargot
agblà	mâchoire
agblaká	mâchoire
agblò	grande cour
agblɔnyinyà	descente
agbofún	bélier
agbojlakà	galipette
agbolàn	viande de mouton
agidigbájá	très démesuré
agídígbó	guimbarde
aglàn	mâchoire
aglanká	mâchoire
aglŭzà	porc
aglŭzà	cochon
aglúzàkpó	porcherie
aglúzasá	jambon
aglúzasì	truie
aglúzasísá	porc castré
aglúzasú	verrat
aglúzasúkwéɖé	mâle castré
aglúzaví	porcelet
aglúzàwutó	porcherie
aglwí	cuiller bois
aglŏbèsé	grenouille
agŭ	igname pilée
aguduwíì	incompétent
aguduwíì	illettré
agùn	foule
agùn	peuple
agùn	assemblée
agùn	communauté
agunglá	tamtam
agwĭn	escargot
agɔnmà	cocotier
agɔntín	rônier
ahàn	boisson
ahanhunnú	tire-bouchon
ahanhunnú	décapsuleur
ahanmúmɛ	enivrement
ahanmúmɛ	ivresse
ahannudíngan	ivrognerie
ahannumú	ivresse
ahannuxwé	buvette
ahannuxɔsá	buvette
ahannuxɔsá	débit boissons
ahanviví	boisson sucrée
ahizì	manigance
ahizì	manœuvre
ahóo	tant pis
ahwàn	guerre
ahwàn	armée
ahwàn	groupe
ahwàn	troupeau
ahwanfunfun	guerre
ahwanfunfun	bataille
ahwanfunnú	arme de guerre
ahwanfɔkpà	chaussure militaire
ahwangán	militaire
ahwangbomɛ	attaque armée
ahwangɔnù	groupe guerriers
ahwànhŭn	navire guerre
ahwànhŭn	avion militaire
ahwanhúngán	officier
ahwanwù	tenue militaire
ahwɛmú	fraîche
ahɔnká	boîte crânienne
ahɔnmɛlalà	scolopendre
ajakà	souris
ajakaja	souricière
ajakaví	souriceau
ajalalasá	salle de rassemblement
ajalalazén	jarre trouée
ajaxwí	passoire
vìjìjì	enfantement
ajì	tactique de jeu
ajiglokwín	testicule
ajijá	hérisson
ajijá	porc-épic
ajijì	imprévu
ajijì	subitement
ajikwín	graine
ajinakú	eléphant
ajitò	planche de jeu
ajò	épargne
ajo	fraude
ajo	vol
ajo	arnaque
ajojijà	voler
ajɔnú	objet de joie
ajɔnŭ	marchandise
ajɔxanú	condiments
aká	grande faim
akán	charbon
akánmú	potasse
akánnújì	pâte levée
akasá	pâte de maïs fermenté
aklákú	hippopotame
aklántà	étagère
aklasú	vautour
aklasú	charognard
akló	barque moderne
aklúzù	croix
aklúzulixò	chemin de croix
akóbá	malheur
akóbá	affaire
akodokwín	poing
akpá	à côté
akpá	partie
akpà	promesse
akpà	vœu
akpà	plaie
akpà	blessure
akpádídó	émission de voeux
akpádídó	formulation de voeux
akpádídó	promesse
akpakpà	émoi
akpakpà	apaisement
akpakpà	tressaillement
akpáwle	perdrix
akpán	bouillie
akpatá	tortue
logozò	tortue
akpaví	carpe
akpavú	enfant prodigue
akpé	brillant
akpé	éclatant
akplă	gaule
akpò	colère
akpo	poche
akpodokwín	poing
akpólà	sabre
akpomɛdukwí	mouchoir
akpónyagidì	homme très rusé
akpótín	maille de bois
akpɔdidó	énervements
akɔjɛgbè	jour
akɔmlámlá	louanges
akɔnyinyi	pari
akɔta	tribu
akɔta	peuple
akɔwé	lettré
alàká	joue
alànnŭ	infamie
alànnúwíwa	commettre des méchancetés
alasí	enquête
alasídídó	enquête
alasídídó	demande de renseignements
alì	chemin
aliklán	carrefour
alĭn	foie
alĭn	houe
alĭn	bêche
alinkàn	ceinture
alisá	plaisanterie
alisátɛn	endroit de relaxation
alisátɛn	endroit de repos
alisáxó	plaisanterie
alita	sur le chemin
alitanù	outils de voyages
alitasìn	eau du voyageur
alixíxá	chemin tortueux
alixò	le chemin
alixosì	nom fille
alò	cure-dents
alŏ	ou bien
alŏkàn	téléphone
alomà	plante amère
alɔbá	plastique
alɔdidó	secours
alɔdó	secours
alɔdudó	secours
alɔfún	poils des bras
alɔgàn	montre
alɔganví	bague
alɔganví	anneau
alɔgbá	bredouille
alɔgogwè	poignée
alɔgólìgŏlì	le
alɔjí	à portée
alɔkpákpá	paume des mains
alɔkpalɔkpà	différentes sortes
alɔkpalɔkpà	différentes manières
alɔkpalɔkpà	différents types
alɔkpáxwì	creux
alɔkpénùjí	pouvoir
alɔmawlíví	enfant illégitime
alɔvíɖòtoé	auriculaire
alɔwlísì	femme mariée chrétiennement
alɔwliwlí	mariage chrétien catholique
alɔɖómɛjí	avoir du support
alɔɖómɛjí	avoir la main sur soi
alɔɖótè	être prêt
alɛxò	incantations
amăgàtín	manguier
amágavivó	mangue mûre
jakpatà	vipère
amasìn	la tisanne
amasìn	remède
amasìn	médicament
amasinnú	médicament
amasinslă	purgatif
amasinxwé	pharmacie
amì	huile
amidàn	couleuvre
amifún	ecume palme
amigbá	bidon d'huile
amijá	résidu de palme
amisin	morve
amŭ	moustique
anɔblanú	soutien-gorge
anɔkwín	jeune sein
anɔnùvínú	mamelon
anɔvínú	mamelon
anɔsín	lait
anɔwlinú	soutien-gorge
anɔwlíwú	soutien-gorge
anɔɖíɖé	sevrage
apóstolù	apôtre
aságá	enjambée
asì	epouse
asibyɔnú	la dot
asidida	mariage
asigegédídá	polygamie
asigegéɖíɖó	polygamie
asísì	co-épouse
asú	epoux
asúdídáhwénú	femme
asúká	courageux
asúsì	femme d'un mari polygame
atá	haricots fris
atagán	oncle ainé du père
atakín	piment
takín	piment
atakíngò	bouteille à piment
atakínsín	liquide pimentée
atakínsótó	boisson à piment
atakún	poivre
atán	salive
atàn	vin palme
atángbán	crachoir
atangò	vin de palme
ataví	oncle
atín	arbre
atínfló	ecorce
atínkàn	liane
atínkwín	graine
atínmá	feuillage
atínsá	sous l'arbre
atínsìn	sève
atínta	la souche
atíntanu	la souche
atínví	bûchette
atínvíyɔywɛ	brindille
atínvú	arbuste
atoké	chauve-souris
avajà	terasse
avaligbé	pâturage
avĭ	pleurs
avĭ	larmes
avĭhàn	chant de tristesse
avilelé	pleurs de souffrance
avivì	frayeur extrême
avivɔfún	chaire de poule
avivɔgblénú	fébrifuge
avivɔhwenu	saison froide
avivɔsùn	mois
aviyaviyà	pleurnichements
aviyiyà	pleurs
avoká	avocat
avɔfɔkpà	pantoufle
avɔfɔkpà	espadrille
avɔkàn	fil de pagne
avɔkàn	coton
avɔkanfún	ouate
avɔkanfúntín	cotonnier
avɔkanɖíɖé	récolte du coton
avɔkíjà	guenille
avɔkpó	pièce
avɔkpò	tissu
avɔlinlɔn	tissage
avɔlinlɔn	tricotage
avɔlɔnnú	métier à tissu
avɔnuvínu	extrémité du pagne
avɔnyinya	blanchissage
avɔtitɔ	couture
avɔvunvún	guenille
avɔwlanwlan	tissu rayé plusieurs couleurs
awà	bras
awă	joie
awăjíjè	enjaillement
awakanmɛkú	découragement
awàságbè	ecureuil
awaɖonú	motif de joie
awífínfán	miaulement
awii	chat
awiisí	chatte
awĭnyà	pierre
awĭnyà	caillou
awìví	chaton
awlinmɛnú	hypocrisie
awŏvì	démon
awŏvì	mal
awŏvì	tentateur
awŏvì	malheur
awù	habit
awù	vêtement
awugbó	bouton
awùkíjà	guenille
awuvúnvún	guenille
awɔnlìn	nigeria
awɔnnu	museau
awɔnnufún	barbe
awɔnnután	moustache
awɔntín	nez
axáywé	gari très fin
axì	marché
axijijɛ	jour du marché
axitó	les abords du marché
axixwlégánnú	faire le marché
axó	cri
axoáɖì	ainsi soit-il
axwá	cri
axwá	appel au secours
axwálokwété	tourterelle
ayá	peigne
ayì	pensées
ayì	esprit
ayì	idée
ayĭkùgban	terre
ayididá	mesquinerie
ayidindán	coeur troublé
ayìdìndán	tremblement de terre
ayidò	trou dans la terre
ayiglaglá	audace
ayiglaglá	hardiesse
ayìhizihízí	diffamation
ayìhizihízí	dissimulation
ayìhizihízínɔn	diffamateur
ayìhizihízínɔn	dissimulateur
ayihún	jeu
ayihún	divertissement
ayihún	chemin terre
ayihún	véhicule terrestre
ayihúndá	jeu
ayihúndá	plaisanterie
ayihúndánu	jouet
ayihunxó	plaisanterie
ayihunxó	blague
ayijàyĭ	paix
ayijàyĭ	sérénité
ayijɛdò	paix
ayijɛdò	confiance
ayikàn	artère
ayikàn	feuilles après récolte
ayikún	haricots
ayikún	fève
ayìkúngban	terre
ayikúnkpínkpán	purée
ayimajɛdò	inquiétude
ayimajɛdò	angoisse
ayìsúndò	caniveau
ayìsúndò	égout
ayisɔnmɔ	la fois passée
ayisɔnmɔ	récemment
ayisɔnmɔ	dernièrement
ayixà	réflexion
ayixà	esprit
ayìzízá	balayage
ayiɖagbeɖiɖó	esprit de bonté
ayìɖóhwɛɖó	arc-en-ciel
ayomà	oignon
ayomása	oignon
ayɔnù	yoruba
azadodó	chéchia
azají	grenier
azănɖókpo	un jour
azànɖíɖó	délai
azavà	paillote
azĕ	maléfice
azĕ	sorcellerie
azĕ	magie noire
azé	maléfice
azé	sorcellerie
azé	magie noire
azĕtɔ	sorcier
azétô	sorcier
aziín	arachide
aziínfíntín	moutarde
aziínfló	peau d'arachide
aziinmí	huile d'arachide
aziínmimɛ	arachide grillée
aziínsísɔ	arachide grillée
aziínsusɔ	arachide grillée
aziíntófó	arachide vide
aziíntófwé	arachide vide
azìn	oeuf
azinfifɛ	arachide grillée
azinkpò	chaise
azizà	génie
azizɔ	fumée
azizɔ	vapeur
azizɔ	nuage
azizɔlì	cheminée
azwì	lièvre
azwì	lapin
azwiví	lapineau
azɔ	travail
azɔbatɔ	chercheur de travail
azɔfúngbá	tabatière
azɔfúnfún	fumer
azɔgba	boîte à tabac
azɔlì	cheminée
azɔngbigbɔ	guérison
azɔngblemá	plante médicinale
azɔngblemaá	plante médicinale
azɔngblenú	remède
azɔngbó	pamplemousse
azɔngɔgwè	sapotille
azɔnjijɛ	tomber malade
azɔnkatikatì	tétanos
azɔnunu	fumer
azɔnví	enfant maladif
azɔwanú	outil de travail
azɔɖuɖu	tabac à chiquer
aɖawùn	ornement
aɖawùn	originalité
aɖawùn	extraordinaire
aɖawùnɖíɖó	ornementation
aɖawùnɖíɖó	belle oeuvre
aɖĭ	savon
aɖidán	très venimeux
aɖìfún	mousse de savon
aɖìgá	flèche empoisonnée
aɖìhún	contre-poison
aɖìká	boîte à savon
aɖimú	ordalie
aɖimɛví	enfant chéri
aɖísí	droite
aɖisimin	côté droit
aɖiví	enfant chéri
aɖò	urine
aɖŭ	dents
aɖùgánnú	aiguiser les dents
aɖukanɖukàn	grincement de dents
aɖùkún	grincement dents
aɖùkúnɖúɖú	grincement dents
aɖùsó	molaire
aɖùsúnsún	perte des dents
aɖɔtwé	vessie
aɖɔwé	héron
adanxo	brutalité
adɔgo ɖaxo	gros ventre
agban kpikpεn	valises lourdes
agban kpikpεn lε	les valises lourdes
agbaza wewe	peau blanche
agbaza wiwi	peau noire
aglan	menton
aglan	mâchoire
ahan fifa	boisson fraîche
ahan syεnsyεn	boisson alcoolisée
aji	affaire
aji ɖagbe	bonne affaire
akanma	lits
bibɔ	une branche
ali gblegble	mauvaises routes
ali nyi ɖokpo	il n'y pas qu'une seule voie dans
alɔ xixa	une crochue
alɔ ɖisi	droite
amisa	église
amisa	messe
amɔ	mais
amɔ	fromage
asi	femme
asicé	ma femme
asitché	ma femme
asi gege	épouses
asi lε	les épouses
asi	épouses
asu	mari
atin	arbuste épineux
atin ɖagbe	bon arbre
avɔvunvun	tissu déchirés
avɔyɔyɔ	tissu neuf
awii atɔɔn	cinq chats
awii gege	plusieurs chats
awii lε	les chats
awii mitɔn	notre chat
awii mitɔn	votre chat
awii yetɔn	leur chat
awii ɖe	un chat
awii ɖe lε	quelques chats
awii ɖokpoɖokpo	chaque
awɔntin gaga	long nez
awɔntin xixa	nez crochu
ayixomεnyinyɔnɔ	bienfaiteur
ayihun gidigidi	jeux violents
ayihɔngbe ɔ	le lendemain
ayijijε	une chute
ayikungban kpikpo	une terre stérile
azan gaga	longues journées
azan nyanya	mauvais journées
azan ɖagbe	bonnes journées
aziin sisɔ	arachides grillées
aziin ɖiɖa	arachides bouillies
azin ɖiɖa	oeufs bouillis
azinsatɔ	vendeur d'oeufs
azinzɔnnɔ	malade
azɔlε	les devoirs
azɔvɔ	le travail est fini
azɔmεvi ajotɔ	écolier voleur
azɔmεvi ɖagbe	bon écolier
azɔn huzu	la maladie a changé
azɔnnabi	combien de fois
azɔn syεn	la maladie est délicate
azɔn vɔ	la maladie est partie
azɔxɔ ayizεn	il
aɖi	le savon
ablo kpεɖe à	as-tu fait peu
ayi bεnεε kpɔn à	es-tu déjà allé au bénin
byɔ eyε	demandes-lui
ahan	boisson
xɔ azin	achètes des oeufs
nɔ yi gbe ganji	réponds-bien
asanu kpεɖe à	as-tu vendu peu
miɖondo fongbe à	parlez-vous le fon
su hɔn ɔ	fermes la porte
tà zogbεn ɔ	allume la lampe
atwi tuwun à	est-ce que le connais
awazɔ kpεɖe à	as-tu travaillé peu
awà gangi à	est-ce que tu es bien arrivé
awà gangi à	est-ce que tu es bien arrivée
miwà gangi à	est-ce que vous êtes bien arrivés
miwà gangi à	est-ce que vous êtes bien arrivées
ɖo akɔnkpinkpan	aies du courage
aɖo cεnji à	as-tu monnaie
aɖo finε à	es-tu là
aɖo gangi à	est-ce que tu vas bien
aɖo kwε à	as-tu de l'argent
aɖo kεɖε à	es-tu en forme
miɖo akɔnkpinkpan	ailez du courage
miɖo cεnji à	avez-vous la monnaie
miɖo finε à	êtes-vous là
miɖo gangi à	est-ce que vous allez bien
miɖo kwε à	avez-vous de l'argent
miɖo kεɖε à	êtes-vous en forme
miɖo xwe gbe à	est-ce que vous êtes à la maison
aɖo xwe gbe à	est-ce que tu es à la maison
aɖo ɖagbe à	vas-tu bien
miɖo ɖagbe à	allez-vous bien
acε gege	pleine de grâces
adan xo	terreur
adingban wε	ce n'est pas vrai
agban kpikpεn wε	ce sont de lourds colis
agban lε kpεn	les colis sont lourds
agbomεnu wε	originaire d'abomey
agbomεnu	originaire d'abomey
ajinaku ɔ klo	l'éléphant est gros
ajotɔ wε nyi	c'est un voleur
ajɔ towe ɖie	voici ton cadeau
akɔta mitɔn lε bi	toute notre famille
akɔta mitɔn lε bi	toute votre famille
alagaa ɔ vɔ	le quai est désert
aligbɔntɔ lε ă	les passants sont rares
alɔ tɔn jlɔ ă	il est maladroit
alɔ ɖe ɔ	l'autre main
alɔmyɔnɔ	gaucher
alɔvi tɔn ɖo vivε wε	sa main lui fait mal
amlɔ azɔn	maladie du sommeil
amlɔgɔ nɔ	somnolant
amɔ gbɔ sukpɔ ă	mais in n'y a pas beaucoup de moutons
amɔ gege kwiji tawun	beaucoup de fromages sont très sales
amɔ wε	c'est du fromage
nukplɔnmεtɔ	enseignant
nukplɔnmεtɔ	professeur
amɔ nukplɔnmεtɔ wε nyi	mais c'est un professeur
amɔ nukplɔnmεtɔ wε nyi	mais c'est un enseignant
tii	thé
amɔ wɔn bi	mais oublies tout
wulεkpa hwε	salle de bain
étè wε zɔn bɔ	pourquoi est-ce que
anɔsinlinfinnɔ	lait maternel
asi ɖo xwe gbe	la femme est à la maison
asi nabi à ɖo	combien de femmes as-tu
asu tɔn wε	c'est son mari
atɔn	trois
atɔɔn	cinq
atɔngɔ	troisième
atɔɔngɔ	cinquième
avivɔ ɖo sisɔ wε	il tremble
awu xoxo	vieux habit
awu	habit
ayihun gidigidi ɖe lε	des jeux brutaux
ayihundanu mitɔn lε bi	tous nos jouets
ayihundanu mitɔn lε bi	tous vos jouets
azan su	le jour est arrivé
azan tantɔn gbe gudo ɔ	après huit jours
azan tεnwe lε ɖie	voilà les sept jours
azan yi atɔn	ça fait un moment
azan yi atɔn	ça fait un bail
azan yi atɔn	il y a trois jours
azan yɔeyɔe ɖe yi	quelques jours sont passés
azan ɖokpoɖokpo	chaque jour
azin ɖe à	il n'y a pas d'oeufs
azinkpo ɔ syεn	le meuble est solide
azinkpo ɔ syεn	la chaise est solide
azinzɔnnɔ ɔ hwla	le malade est arrivé
azinzɔnnɔ ɔ hεn nukiko	le malade garde le sourire
azinzɔnnɔ ɔ ku	le malade est mort
azinzɔnnɔ ɔ syεn wu	le malade reste solide
azinzɔnnɔ ɔ vɔ hlɔnhlɔn	le malade est faible
azinzɔnnɔ ɔ ɖo jiɖe	le malade reste confiant
azwilan ɖe	il y a la viande de lapin
azɔ towe	ton travail
azɔ tε anɔ wa	quel travail fais-tu
azɔmε mitɔn klo à	votre école est-elle grande
azɔmε mitɔn klo à	est-ce que votre école est grande
azɔmεvi	écolier
azɔn gbɔ bi	la maladie a completement disparu
azɔwatɔ	ouvrier
azɔwatɔ alɔjijlɔnɔ	ouvrier
azɔxɔ	bâtiment de travail
azɔxɔ	classe
azɔxɔ wε	c'est un bâtiment de travail
azɔxɔ wε	c'est une classe
xomε ɖo vo	le ventre est vide
é ɖo asi su kpɔ	il a beaucoup de femmes
à ɖo asi su kpɔ	tu as beaucoup de femmes
ùn ɖo asi su kpɔ	j'ai beaucoup de femmes
à ɖe jiɖe ɖo wutu tɔn à	est-ce que tu lui fais confiance
é gblé wu	il est blessé
mi gbɔ azɔn azinzɔnnɔ ɔ	soignez le malade
gbɔ azɔn azinzɔnnɔ ɔ	soignes le malade
atinkεn	médicaments
mi gbɔ azɔn azinzɔnnɔ ɔ kpodo atinkεn ɖetε lε kpo	soignez le malade avec quels médicaments
gbɔ azɔn azinzɔnnɔ ɔ kpodo atinkεn ɖetε lε kpo	soignes le malade avec quels médicaments
do gɔ ɔ ɖo agboɖe	remplis la bouteille à moitié
mido gɔ ɔ ɖo agboɖe	remplissez la bouteille à moitié
hεn tɔn	sors avec
àhεn ɔ ànan tɔn	tu peux sortir
mihεn ɔ minan tɔn	vous pouvez sortir
àhεn ɔ hwlεn togun towe	sauve ton peuple si tu peux
mihεn ɔ mihwlεn togun miton	sauvez votre peuple si vous pouvez
mihεn ɔ mihwlεn togun miton	sauvez vos peuples si vous pouvez
man yovozɔn enε lε xa xɔntɔn towe lε	partages ces oranges avec tes camarades
mi man yovozɔn enε lε xa xɔntɔn mitɔn lε	partagez ces oranges avec vo camarades
éjlo wé anan man yovozɔn enε lε xa xɔntɔn towe lε à	veux-tu partager ces oranges avec tes camarades
éjlo mi minan man yovozɔn enε lε xa xɔntɔn mitɔn lε à	voulez-vous partager ces oranges avec vos camarades
atinsinsεn nyanya ɖokpo ɖo ɖagbe ɖe lε mε	il y a un mauvais bois dans les bons
à mɔn akwε towe à	est-ce que tu as retrouvé ton argent
à mɔ jε mε à	as-tu compris
à mɔ nù jε mε à	as-tu compris
mɔ sukpɔ tobutobu ɖo xixa wε ɔ à	vois-tu le nombre de mouches qui s'attroupent
gbe mε towe lε	les potes
gbe mε towe lε	les amis
hεn xasun ɔ	portes le panier
kpεɖe	un peu
kplekple	réunion
anan ɖo kplekple sín tεnmε à	est-ce que assisteras à réunion
sɔ wema xixa ɖokpo	choisis un quelque chose à lire
sɔ wema xixa ɖokpo	choisis un livre
gɔn kpo ɖɔ xo kpεɖe	viens chez moi et pourrons discuter
xɔ atinsinsεn ɖokpo à	paies et emmènes du bois
xa ɖokpo sɔ yi kanweko	comptes de un à cent
ɖaxo	grand
xa ɖaxo ɔ ji	montes sur le grand
rɔbu	robe
yi rɔbu towe kpɔn	prends ta robe
nɔ à	estce que fais du
xomε sinsin	énervement
nɔ mε	restes dedans
kafε	café
a nù kafε zanzan à	as-tu pris du café le matin
mi nù kafε zanzan à	avez-vous pris du café le matin
axivivε	chereté
nɔ xo nɔ ɖu	achètes à manger
nɔ ɖamlɔ ɖɔ hwebinu	dors tout le temps
nɔ ɖo wezun	cours vite
alokan	téléphone
flansegbe	français
doglensigbe	anglais
ànɔ do flansegbe wε à	parles-tu français
ànɔ doglensigbe wε à	parles-tu anglais
minɔ do flansegbe wε à	parlez-vous français
minɔ doglensigbe wε à	parlez-vous anglais
hwenuxo	conte
hwenuxo	histoire
àsé hwenuxo gudo tɔn à	as-tu entendu la dernière histoire
misé hwenuxo gudo tɔn à	avez-vous entendu la dernière histoire
àsé hwenuxo gudo tɔn à	as-tu entendu le dernier conte
misé hwenuxo gudo tɔn à	avez-vous entendu le dernier conte
ɖayi ɔ	auparavant
toxomε	ville
zemijan	taxi-moto
ùn sixu gɔn alɔma wli	je ne peux pas ne pas marier
a sixu wa aklunɔzangbe à	est-ce que tu peux venir dimanche
mi sixu wa aklunɔzangbe à	est-ce que tu peux venir dimanche
su tɔn wε	c'est son totême
xwegbe	maison
xwe gbe	maison
wamamɔnɔ	pauvres
nukiko	que du rire
nukiko	mort de rire
nukiko	léger sourire
é hwɛn ăn	ce nest pas drôle
awé tché wa nún mín năn nún ahăn	très cher frère vient on prend un pot
tăɖúnɔn	un fou
agɔnkɛ	noix de coco
agɔnkɛ	coco
éhwɛn tawoun	très rigolo
éhwɛn tawoun	très drôle
éhwɛn ɖéébou a	pas du tout drôle
éhwɛn ɖéébou a	pas du tout rigolo
mɛnwí	un noir
mɛnwí	un homme noir
mɛnwíwi	un noir
mɛnwíwi	un homme noir
yóvo	un blanc
yóvo	un homme blanc
bokɔnɔn	marabout
ajotɔ	voleur
ajotɔ	escroc
ajotɔ	bandit
gléssi	un paysan
wékpɛn	un miroir
màwu ní fɔǹ mí	à demain
màwu ní fɔǹ mí	bonne nuit
hwénúsú	il est temps
hwénúsú	l'heure a sonné
xonton towé	ton ami
oh clounon	oh mon dieu
oh klounon	oh mon dieu
évivi ɖín	c'est trop doux
aviyiya	pleurs et larmes
étɛ fún ɖɔ e ɖé	qu'est-ce qu'il raconte
étɛ fún ɖɔ e ɖé	qu'est-ce qu'elle raconte
aluwɛmɛ	tristesse
aluwɛmɛ	mélancolie
aluwɛmɛ	chagrin
un kisi núwe	je t'embrasse
un kisi núwe	un bisou
akoba	étonnement
akoba	oh malheur
akoba	c'est la catastrophe
asanhún	que de la bonne musique
asanhún	j'écoute de la musique
asanhún	musique
akɔwe	savant
akɔwe	savante
akɔwe	jeune intellectuel
akɔwe	jeune intellectuelle
un ɖo bɛncemɛ	je suis dans mes états
un ɖo bɛncemɛ	je suis en forme
un ɖo bɛncemɛ	je suis de bonne humeur
akwɛnɔ	riche
akwɛnɔ	fortuné
un ɖo tamɛ gba wɛ	je réfléchis
tamɛ gbigba	réflexion
tamɛ gbigba	cassetête
sɛvo tɛwɛ	c'est quoi le plan
sɛvo tɛwɛ	c'est quoi le problème
sɛvo tɛwɛ	c'est quoi le souci
sɛvo tɛwɛ	tu joues à quoi
agbɔ kpemi	je suis fatigué
agbɔ kpemi	je suis fatiguée
agbɔ kpemi	je suis épuisé
agbɔ kpemi	je suis épuisée
agbɔ kpemi	je suis essoufflé
agbɔ kpemi	je suis essoufflée
agbɔ kpemi	je suis las
agbɔ kpemi	je suis lasse
agbɔ kpemi	je suis abattu
agbɔ kpemi	je suis abattue
étɛ nin	c'est quoi ça
gǎn bi ɔ	boss
gǎn bi ɔ	chef
gǎn bi ɔ	patron
kpon eyɛ	regarde-moi celui-là
kpon eyɛ	regarde-moi celle-là
mi kpon eyɛ	regardez-moi celui-là
mi kpon eyɛ	regardez-moi celle-là
kpon ta ni	regarde-moi sa tête
mi kpon ta ni	regarde-moi sa tête
hwiɖé	méfies-toi
hwiɖé	attention fais gaffe
mi miɖé	méfiez-vous
mi miɖé	attention faîtes gaffe
é nyɔn númi ǎ	je suis indisposé
é nyɔn númi ǎ	je suis indisposée
é nyɔn númi ǎ	je suis malade
é nyɔn númi ǎ	je suis déprimé
é nyɔn númi ǎ	je suis déprimée
é nyɔn númi ǎ	je ne vais pas bien
é nyɔn ni ǎ	il est indisposé
é nyɔn ni ǎ	elle est indisposée
é nyɔn ni ǎ	il est malade
é nyɔn ni ǎ	elle est malade
é nyɔn ni ǎ	il est déprimé
é nyɔn ni ǎ	elle est déprimée
é nyɔn ni ǎ	il ne va pas bien
é nyɔn ni ǎ	elle ne va pas bien
é nyɔn núyé ǎ	ils sont indisposés
é nyɔn núyé ǎ	elles sont indisposées
é nyɔn núyé ǎ	ils sont malades
é nyɔn núyé ǎ	elles sont malades
é nyɔn núyé ǎ	ils sont déprimés
é nyɔn núyé ǎ	elles sont déprimées
é nyɔn núyé ǎ	ils ne vont pas bien
é nyɔn núyé ǎ	elles ne vont pas bien
odjé	surprise incroyable
odjé	interjection détonnement
odjé	oh
haha agbako	mort de rire
haha agbavia	mort de rire
tcho eblawu	oh que cest triste
tcho eblawu	oh que cest déplorable
tcho eblawu	navrant
tcho adǎn gbomi	la poisse
tcho adǎn gbomi	je suis éprouvé
tcho adǎn gbomi	je suis éprouvée
tcho adǎn gbomi	quel malheur
mahu	dieu
mahu	noù de dieu
mahu é cáki mi	nom de dieu ça m'énerve
mahu é cáki mi	je suis hors de moi
mahu é cáki mi	je suis en colère
mahu é cáki mi	je suis énervé
mahu é cáki mi	je suis énervée
mahu é cáki mi	je suis fâché
mahu é cáki mi	je suis fâchée
rhor nami agbɔ	putain laisse-moi en paix
rhor nami agbɔ	colle-moi la paix
tadu ce djawe	je m-apprête à faire une crise de colère
tadu tɔ djawe	il s-apprête à faire une crise de colère
tadu tɔ djawe	elle s-apprête à faire une crise de colère
djika ɖé	que de la frime
nùkócé nɔn yìn	je m'appelle
un yìn wàn nouwé	je t'aime
uh fɔn gangji	je vais bien
un yìn wàn núwe	je t'aime
un ɖu lɔvu núwe	je t'aime
un ɖu lɔvu núwe	je t'aime
un ɖu lɔvu núwe	je t'apprécie
un ɖu lɔvu núwe	je t'adore
un yìn wàn núwé	je t'aime
un ɖu lɔvu núwé	je t'aime
un ɖu lɔvu núwé	je t'aime
un ɖu lɔvu núwé	je t'apprécie
un ɖu lɔvu núwé	je t'adore
un yìn wàn nouwé	je t'aime
un ɖu lɔvu nouwé	je t'aime
un ɖu lɔvu nouwé	je t'aime
un ɖu lɔvu nouwé	je t'apprécie
un ɖu lɔvu nouwé	je t'adore
rhor mahu	putain
rhor mahu	bon sang
rhor mahu	fais chier
rhor mahu	merde
rhor mahu	bordel
un ɖɔ nti ǎ	je n'ai rien dit
un sé nti ǎ	je n'ai rien entendu
un nti ǎ	je n'ai rien vu
é kpéto	c'est fort
é kpéto	du buzz
é kpéto	la puissance
é jɔ adǎn	c'est fort
é jɔ adǎn	du buzz
é jɔ adǎn	la puissance
towe ɖye	super
towe ɖye	superbe
towe ɖye	excellent
towe ɖye	tu es fort
towe ɖye	tu es forte
mitɔn ɖye	vous êtes forts
aɖanmacio	bravo
aɖanmacio	félicitations
agbɔnɔn	boss
agbɔnɔn	tu es puissant
agbɔnɔn	tu es puissante
agbɔnɔn	tu es fort
agbɔnɔn	tu es forte
éɖabɔ	au revoir
éɖabɔ	à plus
éɖabɔ	à tout à lheure
éɖabɔ	à bientôt
yinwɛ ɖo zo ɖu wɛ	c'est moi la chose
yinwɛ ɖo zo ɖu wɛ	c'est mon heure de gloire
éwlizo	c'est du boom
éwlizo	c'est chaud
é na cɛ núwe	merci
é na cɛ núwe	merci à toi
é na cɛ númi	merci à vous
un sí mɛxó	mes respects
é vɛ numi tawun	j'en suis vraiment choqué
é vɛ numi tawun	j'en suis vraiment choquée
é vɛ numi tawun	j'en suis vraiment énervé
é vɛ numi tawun	j'en suis vraiment énervée
é vɛ numi tawun	ça ma vraiment énervé
é maché ɖebu ǎ	ça ne marche pas du tout
é maché ɖebu ǎ	ce n'est pas okay
tchin é maché	cool
tchin é maché	ça marche
tchin é maché	c'est okay
tchin é maché	okay je valide
tchin é maché	j'approuve
nawunnawun tɛɛ	c'est doux mais je ne te donne pas
un ɖo awadjidjè mɛ	je suis en joie
un ɖo awadjidjè mɛ	je suis heureux
un ɖo awadjidjè mɛ	je suis heureuse
un ɖo awadjidjè mɛ	je suis content
un ɖo awadjidjè mɛ	je suis contente
boumin	quitte-là hein
boumin	dégage
haha vivi bi wɛ	c'est trop cool
bèlèloou	rire taquin
haha aɖɔgo ce	haha mon ventre
aɖumi tawun	tu es malade
agoo mǎ yii	je m'en vais
agoo mǎ yii	je passe
djo gué ce ɖo	laisse-moi courir
midjo gué ce ɖo	laissez-moi courir
haha avoun towe	haha connard va
hein	quoi
étɛkanyinɖémɛ	j'ai quoi à voir là-dedans
étɛkanyinɖémɛ	en quoi suis-je concerné
étɛkanyinɖémɛ	en quoi suis-je concernée
étɛkanyinɖémɛ	est-ce mon affaire
étɛkanyinɖémɛ	je n'en ai rien à foutre
un ɖu aɖi	je suis énervé
un ɖu aɖi	je suis énervée
un ɖu aɖi	je suis faché
un ɖu aɖi	je suis fachée
un ɖu aɖi	je suis en colère
awotcho	zut
awotcho	dommage
évɛwumɛ	c'est dur
évɛwumɛ	c'est difficile
axɔsi	reine
axɔsi	princesse
axɔsi	belle dame
axɔsu	roi
axɔsu	prince
axɔsu	charmant
axɔsu	bel homme
amiii	amen
axoadi	ainsi soitil
dagbédagbé	victoire
dagbédagbé	que du bien
un ɖi nu nà	j'aime bien
un ɖi nu nà	j'apprécie
un ɖi nu nà	ça me séduit
doo núwe	salut
doo núwe	bonjour à toi
doo núwe	bonsoir à toi
ago mǎ ɖu we	laisse-moi danser
un ɖo zomɛ	je suis soûlé
un ɖo zomɛ	je suis soûlée
un ɖo zomɛ	je suis ivre
tchintchin go tchin	trinquer
tchintchin go tchin	porter un toast
tchintchin go tchin	tchine-tchine
ví gblégblé	enfant gâté
ví gblégblé	voyou
allô mɛ wɛ	allô c'est qui
allô mɛ wɛ	allô qui cest
allô mɛ wɛ	allô à qui ai-je lhonneur
daho	grand voleur
daho	grande voleuse
foouunn	ça sent la merde
koyiii sɛ xo yi	laisse ton affaire tu exagères
koyiii sɛ xo yi	laisse ton affaire tu en fais trop
kuɖo jigbézǎn	joyeux anniversaire
dɛdɛ	doucement
dɛdɛ	ne te fâche pas
wignan xó	une affaire honteuse
wignan xó wè	c'est une affaire honteuse
cikɔyii	c'est la honte
essanglan nuwe	tu as la chance sinon
haha à houin dín	haha tu es trop drôle
haha à houin dín	haha tu es ridicule
adigban wɛ	c'est un mensonge
é nyɔn un ko sé	okay c'est entendu
é nyɔn un ko sé	okay j'ai compris
xɛsín ɖemɛ ǎ	il n'y a pas de crainte
un ɖéji	j'ai confiance
un ɖéji	je suis zen
un ba xó a	ne me cherche pas querelle
un ba xó a	attention ne me cherche pas
un ba xó a	je ne suis pas d'humeur à m'amuser
devoninmɛ	c'est étrange ça
wli bizu zozo elɔ	attrape ce bisou chaud
un ko	je me suis déjà tu
un ko	je me suis déjà tue
un ɖo gboya	j'ai de l'audace
gboya wɛ	c'est de l'audace
un siyin dín	je suis très fort
un siyin dín	je suis très forte
un siyin dín	je suis très courageux
un siyin dín	je suis très courageuse
adigban	mensonge
un ɖi ă	je ne crois pas
tà fin mi azonɖokpo	ça ma donné des maux de tête sur le champ
avoun loki	espèce de singe
ago ma fan ɖo	je prends la fuite en escaladant le mur
ago vounzin	je m'enfuis à vélo
nùnùɖù	nourriture
nùnùɖù vivi	nourriture délicieuse
sɔguilija ago ma yi bo wa	je prends la fuite à cheval
wa mi na yǐ kwín	viens quon se batte
ezanwé	tu te trompes largement
ezanwé	il t'a trompé largement
ezanwé	ils t'ont trompé largement
yɛyinon	tu es bête
adjagbalou	imbécile
kinklin	je m'excuse
sɔkɛmi	pardonnes-moi
mi sɔkɛmi	pardonnez-moi
eku yéé eku yaa	allez les ecureuils le onze national
mî gbla mi	j'ai envie de chier
mi na ɖu čaki kpowun wɛ	vous allez en souffrir mais vous ne pouvez rien faire
djah satani	arrière satan
djɛbɛtɛ	je bave
djɛbɛtɛ	je suis ébahi
djɛbɛtɛ	je suis ébahie
djɛbɛtɛ	je suis hébété
djɛbɛtɛ	je suis hébétée
amlɔn sami	j'ai sommeil
dotohoué	hôpital
yovotomɛ	europe
yovotomɛ	amériques
yovotomɛ	pacifique
yovotomɛ	asie
un gni	je suis
un ɖo	je suis à
aflika	africa
popovi jiji	originaire de popo
gléxwévi jiji	originaire de ouidah
agbomɛvi jiji	originaire dabomey
gbɔhikɔnvi jiji	originaire de bohicon
xɔgbonuvi jiji	originaire de portonovo
kalavivi jiji	originaire de calavi
akassatovi jiji	originaire dakassato
alladavi jiji	originaire dallada
tɔfɔvi jiji	originaire de toffo
agonlivi jiji	originaire dagonli
lokossavi jiji	originaire de lokossa
plakuvi jiji	originaire de parakou
djougouvi jiji	originaire de djougou
dassavi jiji	originaire de dassa
bantɛvi jiji	originaire de bantè
natitingouvi jiji	originaire de natitingou
dogbovi jiji	originaire de dogbo
saxwɛvi jiji	originaire de lethnie sahouè
péɖahvi jiji	originaire de lethnie xwéda
sèxwɛvi jiji	originaire de sèhouè
adjavi jiji	originaire dadja
comɛvi jiji	originaire de comé
dangbovi jiji	originaire de dangbo
zèvi jiji	originaire de zè
golovi jiji	originaire de glo
sakétévi jiji	originaire de sakété
kétouvi jiji	originaire de kétou
ifangnivi jiji	originaire difangni
kandivi jiji	originaire de kandi
tanguiétavi jiji	originaire de tanguiéta
bembèrèkèvi jiji	originaire de bembèrèkè
sôtchanxwévi jiji	originaire de sô tchanhoué
ganviévi jiji	originaire de ganvié
azovévi jiji	originaire dazové
agouévi jiji	originaire dagoué
hilacondjivi jiji	originaire de hilacondji
agonkanmɛvi jiji	originaire dagonkanmé
dekanmɛvi jiji	originaire de dékanmey
kpɔmasɛvi jiji	originaire de kpomassè
jiji	originaire de sègbohouè
guezinvi jiji	originaire de guézin
gogotinkponmɛvi jiji	originaire de gogotinkpon
tɔkpadomɛvi jiji	originaire de tokpadomey
drɛvi jiji	originaire de drè
jiji	originaire de sè
zinviévi jiji	originaire de zinvié
sowavavi jiji	originaire de sôavai
avlankuvi jiji	originaire davrankou
tangbovi jiji	originaire de tangbo
wawatavi jiji	originaire de wawata
hinvivi jiji	originaire de hinvi
čumičumivi jiji	originaire de tchoumi-tchoumi
kuwandévi jiji	originaire de kouandé
koblyvi jiji	originaire de cobly
bukumbevi jiji	originaire de boukoumbé
sɛgbanavi jiji	originaire de ségbana
zakpotavi jiji	originaire de zakpota
zanyanadovi jiji	originaire de zagnanado
savɛvi jiji	originaire de savè
kalimamavi jiji	originaire de karimama
un ɖo agla	je suis à agla
un ɖo misɛbɔ	je suis à missèbo
un ɖo godomɛ	je suis à godomey
un ɖo akpakpa	je suis à akpakpa
un ɖo sèkanji	je suis à sèkandji
un ɖo sèmɛ	je suis à sèmé
un ɖo toxo ɔ mɛ	je suis dans la ville
un ɖo gléta	je suis au village
un ɖo kalavi	je suis à abomeycalavi
un ɖo akassato	je suis à akassato
un ɖo kutɔnu	je suis à cotonou
un ɖo yovotomɛ	je suis en europe
un ɖo totaligbé	je suis dans le nordbénin
un ɖo kajɛhun	je suis à cadjèhoun
un ɖo	je suis à fidjrossè
un ɖo ganhito	je suis à ganhi
un ɖo tɔkpa	je suis à dantokpa
un ɖo	je suis à vèdoko
un ɖo aflika gbéji	je suis dans un pays de lafrique
un ɖo etoalu rlouju	je suis à la place de letoile rouge
un ɖo xuta	je suis à la plage
un ɖo kpahu	je suis à pahou
un ɖo tɛlin	je suis au terrain
un ɖo gbegamɛ	je suis à gbégamey
un ɖo kokotomɛ	je suis à cocotomey
un ɖo kokokɔji	je suis à cococodji
un ɖo banikani	je suis à banikani
un ɖo azomɛ	je suis au boulot
un ɖo houégbé	je suis à la maison
un ɖo houégbé	je suis chez moi
un ɖo dotohoué	je suis à l'hôpital
un ɖo dotohoué	je suis à la clinique
noix de coco	agonkɛ
igname	tévi
piment	takin
oeuf	azin
fɛnnyɛ	manioc
dotɛ	gingembre
févi	gombo
kókwé	banane
klé	citron
hweví	poisson
dégon	crevette
amǎgà	mangue
ayomà	oignon
timáti	tomate
nɔvi sunu	cher frère
nɔvi nyɔnu	chère soeur
mi ma fɔn ganji á	êtes-vous bien réveillés
mi ma fɔn ganji á	êtes-vous bien réveillées
mi ma fɔn ganji á	vous vous êtes bien réveillés
mi ma fɔn ganji á	vous vous êtes bien réveillées
a ma fɔn ganji á	es-tu bien réveillé
a ma fɔn ganji á	es-tu bien réveillée
a ma fɔn ganji á	tu es bien réveillé
a ma fɔn ganji á	tu es bien réveillée
a ma fɔn ganji á	tu tes bien réveillé
a ma fɔn ganji á	tu tes bien réveillée
afɔngănji ɑ	es-tu bien réveillé
afɔngănji ɑ	es-tu bien réveillée
afɔngănji ɑ	tu t'es bien réveillé
afɔngănji ɑ	tu t'es bien réveillée
mifɔngănji ɑ	êtes-vous bien réveillés
mifɔngănji ɑ	êtes-vous bien réveillées
mifɔngănji ɑ	vous vous êtes bien réveillés
mifɔngănji ɑ	vous vous êtes bien réveillées
un fɔn gănji	je me suis bien reveillé
un fɔn gănji	je me suis bien reveillée
mi fɔn gănji	nous nous sommes bien reveillés
mi fɔn gănji	nous nous sommes bien reveillées
mi kudo zanzan	bonjour
bo kudo zanzan	bonjour
mi kudo zanzan	recevez le bonjour
bo kudo zanzan	reçois le bonjour
kú do lé hwé nún	bon après-midi
mi kú do lé hwé nún	bon après-midi
kúdo gbáda	bonsoir
mi kúdo gbáda	bonsoir
kúdo gbáda	reçois le bonsoir
mi kúdo gbáda	reçevez le bonsoir
zanzan	matin
ganwéwé	midi
gbada	soir
gbadanu	soir
zan	nuit
azan	jour
sɛgblamɛ	semaine
aklunɔzanglamɛ	semaine
vodungbégblamɛ	semaine
sún	mois
súnzan	mois
xwé	année
xwé nú miɖé	nous sommes entrain de fêter
xwé nú miɖé	nous sommes entrain de célébrer
xwé nú miɖé	nous fêtons
xwé nú miɖé	nous célébrons
cɛju	minutes
cɛju	minute
nukunxwixwé	secondes
nukunxwixwé	seconde
gan	heure
gan	fer
sɔ é wayi	hier
sɔ é djawé	demain
sɔ	hier
sɔ	demain
egbé	aujourd'hui
tɛnigbé	lundi
taatagbé	mardi
azangagbé	mercredi
nyɔnuzanbgé	jeudi
axɔsuzangbé	vendredi
sibigbe	samedi
aklunɔzangbé	dimanche
vodungbé	dimanche
aluunsu	janvier
zofinkplɔsun	février
xwéjisun	mars
lidosun	avril
nuxwasun	mai
nukunxwasun	mai
ayidosu	juin
liyasun	juillet
avivɔsun	août
zosun	septembre
kɔnyasun	octobre
abɔxwisun	novembre
wosun	décembre
woosun	décembre
ta	tête
nu	bouche
atan	barbe
awa	bras
vɛgo	gorge
taka	cerveau
tamɛfɔn	cerveau
ɖa	cheveu
ɖa	cheveux
afɔgo	cheville
afɔgoli	cheville
wunda	cil
wundafun	cil
nɛgbéxu	colonne vertébrale
hunvɔvɔkan	artère
hunvɔvɔli	artère
agbaza	corps
ajajaxu	côte
kɔ	cou
awagoli	coude
taka	crâne
takago	crâne
ahɔnka	crâne
asa	cuisse
aɖu	dent
nɛngbé	dos
abɔ	épaule
abɔji	épaule
abɔta	épaule
adɔgo	estomac
adɔgbo	estomac
yonu	fesses
yonu ɖàxo	grosses fesses
yonu ɖàho	grosses fesses
adigoué	fesses
adigwé	fesses
adigoué gbohoun gbohoun	grosses fesses
adigwé gbohoun gbohoun	grosses fesses
alin	foie
nukɔn	front
koli	genou
koligo	genou
alinmɛ	hanche
logomɛ	hanche
adɔkan	intestin
adɔvi	intestin
afɔ	jambe
asa	jambe
alaka	joue
klɛn	joue
ɖɛ	langue
avi	larme
ɖasin	larme
nuflo	lèvre
aglan	mâchoire
aglanka	mâchoire
alɔ	main
gbakɔ	menton
gbakwɛ	menton
awɔnnufu	moustache
awɔnnuta	moustache
kan	muscle
awɔntinli	narine
awɔntinsomɛ	narine
taglomɛkan	nerf
awɔntin	nez
hɔnvi	nombril
hɔn	nombril
tagudo	nuque
zogudo	nuque
nukun	oeuil
fɛnvị	ongle
fɛn	ongle
afɔkpɑkpa	paume de pied
to	oreille
alɔvi	doigt
afɔvi	orteil
xú	os
nukunflo	paupière
nukunflo	paupières
anyu	peau
afɔ	pied
alɔgo	poignet
alɔkwɛ	poignet
akpodokwin	poing
akodokwin	poing
akɔnta	poitrine
akɔn	poitrine
alɔsu	pouce
fijo	poumon
fejo	poumon
fojo	poumon
alinmɛ	rein
alin	rein
mami	ride
atan	salive
hunsin	sang
anɔ	sein
wunda	sourcil
xugloxu	squelette
xukplakpla	squelette
dɛn	sueur
afɔgbɛnnu	talon
hunli	veine
lanmɛkan	veine
lanmɛkankpɛvi	veine
adɔgo	ventre
nukunmɛ	visage
zɑkɛtɛ	gabari
kanlin	animal
wiin	abeille
lɛngbɔvi	agneau
hɔn	aigle
sɔ kɛtɛkɛtɛ	âne
yɛ	ombre
yɛglétété	araignée
xuhwévi ɖaxo	baleine
xumɛhwevi ɖaxo	baleine
kpakpa	canard
lakunmi	châmeau
awii	chat
ase	chat
sɔ glija	cheval
sɔ glidja	cheval
gbɔ	chèvre
avun	chien
cuku	chien
agluza	cochon
agluza	porc
koklosu	coq
agasa	crabe terrestre
asɔn	crabe marrin
aglobésé	crapaud
lo	crocodile
ahunhwin	dauphin
agbe	écureuil
awasagbé	écureuil
ajinaku	éléphant
gwin	gros escargot
akwete	petit escargot
azinzɛn	fourmie
zinzɛn	fourmie
la	girafe
hagbaka	gorille
bésé	grenouille
gbɔnvɛ	guêpe
gbɔnvɛn	guêpe
ajijakuzɛn	hérisson
azexɛ	hibou
klwele	hibou
ɖɛgbo	hippopotame
azɔnxɛ	hirondelle
nuɖogbɛ winniwinni	insecte
kpɔ	léopard
gbekpɔ	léopard
jɔgle	libellule
azwi	lapin
azwigbemɛtɔn	lièvre
kinikini	lion
sukpɔ	mouche
zansukpɛ	moustique
amu	moustique
gbɔ	mouton
lɛngbɔ	mouton
xɛvi	oiseau
xɛ	oiseau
awaɖakpɛkpɛ	papillon
awɛwɛ	papillon
kɛsɛ	perroquet
cakoo	perroquet
cukpa	perroquet
ahwannɛ	pigeon
ahwannɛxɛ	pigeon
hwevi	poisson
koklosi	poule
kpaxɔ	puce
acu	rat
afin	souris
gbowelé	requin
asan	sangsue
bɔklé	sauterelle
bɔsaklé	sauterelle
dan	serpent
ató	singe
ato	singe
zinwo	singe
lumɔ	taupe
logozo	tortue
nyibu	vache
nyibuvi	veau
jɔhɔn	air
atin	arbre
akwɛ	argent
atin	bois
kpo	bois
kpo	bâton
atinla	branche
yozo	chaleur
zozo	chaleur
jixwé	cieux
jixwé	ciel
xu	mer
xuta	côte
xuto	plage
gbexloxlo	désert
axekoji	désert
sin	eau
sunvi	étoile
zo	fer
ama	feuille
flowa	fleur
tɔ	fleuve
tɔsisa	fleuve
zun	forêt
avivɔ	froid
azizɔ	fumée
glasi	glace
gbéhan	herbe
gbé	herbe
tɔlɛdayikungban	île
singbamɛ	innondation
tɔɖisin	innondation
tɔ	lac
tɔgwédé	lac
weziza	paix
weziza	lumière
sún	lune
wɛkɛ	terre
gbè ɔ	monde
gbè	vie
so	montagne
so	montagnes
sokanmɛ	montagne
sokanmɛ	montagnes
jɔfun wewe	neige
akpɔkpɔ	nuage
sika	or
weman	papier
pierre	awinnya
atinvu	plante
ji	pluie
afuntuntun	poussière
ɖɔ	racine
sowinya	rocher
kɔ	sable
hwe	soleil
jɔhɔn syɛnsyɛn	tempête
ayi	terre
ayikungban	terre
jɔhɔn	vent
kɔfu	verre
bénɛnví sunù	citoyen béninois
bénɛnví	citoyenne béninoise
tó ɖé sé hùn ní ɖɔ nù tó ɖé	que l'oreille qui entende dise à l'autre oreille
wéwé	blanc
fɛsin	bleu
koklojo	jaune
koklojonɔ	jaune
wiwi	noir
vɔvɔ	rouge
amamu	vert
taligbé	nord
afɔligbé	sud
hwefɔntɛn	est
hwetintɔnji	est
gbadahwéji	ouest
hweyixɔtɛn	ouest
keze ɔ mɛ ni nyɔ nu mibi sese	que la journée vous soit belle
keze ɔ mɛ ni nyɔ nu mibi sese	bonne journée
keze ɔ mɛ ni nyɔ nu mibi sese	passez une bonne journée
keze ɔ mɛ ni nyɔ nu mibi sese	passez une belle journée
keze ɔ mɛ ni nyɔ nu wé sese	que la journée te soit belle
keze ɔ mɛ ni nyɔ nu wé sese	bonne journée
keze ɔ mɛ ni nyɔ nu wé sese	passes une bonne journée
keze ɔ mɛ ni nyɔ nu wé sese	passes une belle journée
un tuwun ɖɔ wamamɔnɔ wε nyi	je sais que tu es pauvre
ayi aximε wε à	es-tu allé au marché
azɔ ganxixo enε ɔ bi wε à	travaillé tempslà
awa fi ɖokpo à	es-tu venu ici une fois
miwa fi ɖokpo à	êtes-vous venus ici une fois
ɖaxo nu nyɔnu lε bi	la femme ainée
sεn	la loi
xo ɔ ɖi	la parole a eu effet
a xɔ kpεɖe à	as-tu acheté peu
mi xɔ kpεɖe à	avez-vous acheté peu
a xɔ wema wε à	as-tu acheté des livres
mi xɔ wema wε à	avez-vous achetés des livres
a yi gbe à	le permets-tu
yi kutɔnu bo yi bà atinkεn	vas à cotonou chercher des médicaments
a yìn wàn númi à	est-ce que tu m'aimes
mi yìn wàn númi à	est-ce que vous m'aimez
mεslεtɔ	traitre
a ze mi mɔ mεslεtɔ abi	tu me prends pour un traître n'est-ce pas
ze nuxixawema towe	prends ton livre
kutɔnu	cotonou
azan nabi ɖie mi yi kutɔnu	nous avons visité cotonou il y a quelques jours
aɖi ɖɔ é nan lɛ kɔ wà a	penses-tu qu'il va revenir
amanga	mangues
a ɖo awu towe hεn kwiji wε	tu salis ton habit
ɖo azin xɔ wε	achètes des oeufs
ɖo azɔn gbɔ nε wε	sois en train de le guérir
a ɖo dictionnaire zan wε à	es-tu en train d'utuliser le dictionnaire
a ɖo gege à	as-tu assez
hwε to wé jɔ	tu as raison
a ɖo hwεjijɔ	tu as eu justice
jiɖiɖe	confiance
a ɖo jiɖiɖe ɖo wutu tɔn à	est-ce que tu lui fais confiance
a ɖo jiɖiɖe ɖo wutu cé à	est-ce que tu me fais confiance
nu kafe	bois du café
ɖo kwin wε	joues aux billes
za kɔhota	balaies la cour
yi za kɔhota	vas balayer la cour
aɖo nà xwe ɖo nukplɔnmε lε	tu devrais suivre les recommendations
aɖo ɖan su axɔ	tu dois payer la dette
aɖo ɖan su axɔ cé	tu dois me payer ma dette
aɖo nan yi glεnsi tomε xwe lε bi ɔ	tu dois être en angleterre tous les ans
aɖo ɖan ɖɔ	tu dois raconter
aɖo ɖan ɖɔ númi	tu dois me raconter
nugbo	vérité
nugbo wè	c'est la vérité
nugbo wè	c'est vrai
aɖo nugbo ɖɔ wε	tu dis la vérité
nukpakpa	les environs
aɖo nugbo ɖɔ wε a	tu ne dis pas la vérité
aɖo nukpakpa gbɔn wε	tu rôdes dans les environs
nuwlannu towe lε wε	ce sont tes affaires
sukpɔ	la mouche
wli sukpɔ ɔ	attrapes la mouche
ɖo sukpɔ ɔ wli wε	sois en train d'attraper la mouche
ɖo ɖagbe kεlε yi wε	beaucoup de bonnes choses à toi
aɖo wezunkinkan kpoɖo hun kpo wε	tu conduis trop vite avec l'engin
xɔntɔn	ami
xɔntɔn	amie
xɔntɔn	amis
xɔntɔn	amies
xɔntɔn lε	les amis
xɔntɔn lε	les amies
ahwannε	les pigeons
ahannumunɔ wε nyi	c'est un alcoolique
ahwanfuntɔ lε xwe ɖo mε lε gɔn	les soldats sont logés chez les habitants
ahwannε lε nɔ adɔ yetɔn ɖo mε	les pigeons nichent dans les trous des murs
ajaka	rat
ajaka lε	les rats
kponɔ lε	les gendarmes
ajaka lε nɔ nɔ kɔ glɔε	les rats vivent sous la terre
ajinaku tà afɔ logozo ɖokpo ji	l'éléphant a piétiné une tortue
ajotɔ ɔ kpodo cuku tɔn kpo ɖo zɔzɔ gbɔn kponɔ lε wε	le voleur et son chien se méfient des gendarmes
akaju	noix de cajou
akwε nabi wε a nɔ ɖu ɖo sùn ɖokpo mε	quel salaire reçois-tu par mois
akɔ towe ɖo gangi à	est-ce que ta famille va bien
akɔnkpinkpan	courage
akɔnta	la poitrine
akɔnkpinkpan wanyinyi kpodo nunamε kpo nyi biba	recevez le courage  l'amour et la générosité sont des valeurs rares à cultiver
akɔnta wε nyi ɖaxo wutu mitɔn tɔn	la poitrine est la partie principale du corps
ali lε gɔ	les routes sont inondées
ali nukɔnnukɔntɔn kutɔnu tɔn lε	les premières routes de cotonou
wegɔ	deuxième
ali wegɔ ɔ aɖisimε	la deuxième voie à droite
ali ɔ dwiin gblεlε	la voie est très longue
xwe ɔ gbe	dans la maison
é ɖo xwe ɔ gbe	il est dans la maison
é ɖo xwe gbe	il est à la maison
a nɔ mɔ nu ganji ă	vois-tu bien
é ɖo alɔ zinzin ɖo kpo ji	il s'appuie sur une canne
alɔ ɖo ɖuɖu wε	il a mal à la main
zεn	marmite
ɖagbe	bonne
ɖagbe	bon
ɖokpo	un
ɖokpo	une
alɔtrɔ	le lézard
hwan lε	les pierres
alɔmajlɔnɔ to wé ɔ gba zεn ɖagbe ɖokpo	ta maladresse a cassé une bonne marmite
alɔnuzɔwatɔ wε nyi tɔ towe à	ton père est-il un ouvrier
alɔnuzɔwatɔ wε nyi tɔ towe	ton père est un ouvrier
alɔtrɔ ɔ hwla ɖo hwan lε mε	le lézard s'est caché entre les pierres
amanga lε mya ganji nyi ɖuɖu ă	les mangues ne sont pas assez mûres pour être consommées
aɖo ɖagbe ɖe wε	tu dégages une bonne odeur
vεgomε	la gorge
amasin zozo ɔ nɔ mε vεgomε	la tisanne trop chaude brûle la gorge
mεhuhu	le terrorisme
amerika ganhwεndoto	l gouvernement americain
amerika ganhwεndoto lε ze gbe ɖɔ gɔ adan nutitɔ su kun mεhuhu ɔ mε	le gouvernement américain décidé d'amplifier lutte contre le terrorisme
gleta	village
amisa ɖo gleta towe mε à	il y a-t'il une église dans ton village
amisa ɖo gleta towe mε	il y a une église dans ton village
amisa ɖo toxo towe mε	il y une église dans ta ville
amisa ɖo toxo towe mε à	il y a-t'il une église dans ta ville
amlɔ ɖo sisa mi wε	j'ai sommeil
amlɔ ɖo sisa mi wε	nous avons sommeil
amɔ ɖa nu kafe	mais je boirai du café
ali nɔ ɖo dindin wε zanzan	le traffic est fluide les matin
belijik nyɔ hu	je préfère la belgique
dotoo	docteur
un yi dotoo	je suis un docteur
é ko tuwun xo ɖɔ ganji	il sait déjà très bien parler
tagba	les problèmes
togbè	boss
tôgbè	boss
blewun blewun	très rapidement
blewun	rapidement
é nɔ mnɔ tagba blewun blewun	il a souvent des problèmes assez rapidement
azɔ lε nɔ ci kɔ	les travaux sont épuisants
amɔ fitε é gbɔn tahun	mais où est-il donc vraiment passé
amɔ fitε é ka gbɔn tahun	mais où est-il donc vraiment passé
jɔhɔnmεhun	l'avion
tεnnε mε	à neuf heures
jɔhɔnmεhun nɔn yi ɖo gan tεnnε mε zanzan	l'avion partira à neuf heures du matin
tɔ kpodo nɔ kpo ɖo xèsi ɖi wε	le père et la mère ont peurs
tɔsisa	la rivière
éɖo avi ya wε	elle pleure
éɖo avi ya wε	il pleure
yéɖo avi ya wε	ils pleurent
yéɖo avi ya wε	elles pleurent
atin gege ɖo bεnεε toxo lε mε	il y a beaucoup d'arbres dans les villes béninoises
atingbotɔ	le bûcheron
atingbotɔ ɔ ɖo goxɔ gba wε	le bûcheron construit une hutte
atinsinsεn enε ɔ jε nεgbe ajinaku ɖokpo	l'arbre est tombé sur un éléphant
azinkpo mitɔn yɔyɔ lε ɖo finε	nos nouveaux meubles sont là
azinkpoblotɔ wε nyi	c'est un menusier
azinkposatɔ wε nyi	il est un marchand de meubles
azinkposatɔ wε nyi	c'est un marchand de meubles
azinzɔnnɔ ɔ hwla ɖo zan gwlε	le malade s'est caché sous le lit
azinzɔnnɔ ɔ mɔ nuti ɖu gbadanu elɔ	le malade n'a rien eu à manger ce soir
azinzɔnnɔ ɔ mɔ nuɖuɖu zanzan elɔ	le malade n'a rien trouvé à manger ce matin
kokwe	banane
kokwe mymian	une banane mûre
azinzɔnnɔ ɔ ɖo kokwe ɖokpo ɖu wε	le malade est en train de manger une banane
azinzɔnnɔ ɔ ɖo sεn wε kpodo jivi kpo	le malade avec couteau
azinzɔnnɔ ɔ ɖo amasin nu wε	le malade boit la tisanne
azinzɔnnɔ ɔ ɖo amasin vεsεvεsε nu wε	le malade boit un médicament amère
azinzɔnnɔ ɔ ɖo amasin ɔ kpɔn wε	le malade regarde le remède
azinzɔnnɔ ɔ ɖo amasin ɔ kpɔn wε kpodo jlo kpo	le malade regarde avec envie le médicament
azinzɔnnɔ ɔ ɖo amasin ɔ kpɔn wε ɖi jlo mε ɖɔhun	le malade regarde avec dégoût le remède
azinzɔnnɔ ɔ ɖo xo ɖɔ xa doto ɔ wε	le malade est entrain de discuter avec le docteur
azinzɔnnɔ ɔ ɖo xɔ tomε	le malade est dans sa chambre
azinzɔnnɔ ɔ ɖo xɔ ɔ mε wε à	le malade est-il dans sa chambre
azinzɔnnɔ ɔ ɖo zan tɔn ji	le malade est sur son lit
gudo	derrière
nukɔn	devant
azinzɔnnɔ ɔ ɖo zan ɔ gudo	le malade est derrière le lit
azinzɔnnɔ ɔ ɖo zan ɔ nukɔn	le malade est devant le lit
azinzɔnnɔ ɔ ɖo zozo tɔn yi wε	le malade prend température
azizɔnnɔ ɔ ɖo xwe tɔn gbe	le malade est dans sa maison
azizɔnnɔ ɔ ɖo xwe ɔ gbe	le malade est dans la maison
azwi lε ɖo wezun wε ɖo gle ɔ mε	les lapins courent dans le
azwi ɔ ɖo do kun wε	le lapin creuse
azwi ɖo hwihwla ɖo atinsomε	le lapin dans le
azɔ mitɔn lε bi vɔ	tous nos devoirs sont
azɔ nɔ bε ɖo gan tantɔn mε	les cours commencent à huit heures
azɔngbɔnu mitɔn	le soignant
bă	fouet
babá	la boue
nu bi gudo ɔ	après tout
bi nε	voilà tout
bi ɖie	voici tout
dεdε mε	fais doucement
un nɔ ɖɔ fransegbe glεsingbe kpodo italiεn kpo ganji	je parle le français  l'anglais et l'italien couramment
kεkε	la moto
un ɖo kεkε kun wε	je conduis la moto
un ɖo xwe ɖo gleta	j'ai une maison à campagne
vi kpεvi ɔ ɖo xwe tennε	le petit a neuf ans
é ɖi gà	il est élancé
é ɖi gà tahun	il est très élancé
é xwegli	il est court
é xwegli tahun	il est très court
a jɛ xwe gbe ɔ ɖo númi	dis-moi dès que tu arrives à la maison
mɛ lɛ nɔ su kpɔ ɖo amisa	il y a assez de monde à la messe
un bà bonú a na yin asicé	je veux que tu sois ma femme
xwe lo	et toi
xɔ enɛ ɔ ɖokpo	achètes-en un
xɔ suklé wa	achètes et emmène du sucre
un ja xo balɔn	je veux jouer au ballon
un ja xo balɔn	je veux jouer au football
un ja blo supɔ kpeɖe	je veux faire un peu de sport
un ja blo kan wezun kpeɖe	je veux courir un peu
un ja ɖisa kpeɖe	je veux marcher un peu
un ja ɖisa kpeɖe	je veux me balancer un peu
un ja da ayihun kpeɖe	je veux m'amuser un peu
un ja kplon wéman kpeɖe	je veux étudier un peu
é jlo mi man	j'ai envie de
é jlo mi man ji han	j'ai envie de chanter
é jlo mi man da mlɔn	j'ai envie de dormir
é jlo mi man gbɔ jε	j'ai envie de me reposer
tchin	super
tchin	cool
tchin	génial
éɖo tchin	c'est super
éɖo tchin	c'est cool
éɖotchin	c'est génial
biɔwuiɖémεn	ressaisis-toi
biɔ wui ɖémεn	ressaisis-toi
manjomido o	ne me laisses pas
mandjomido o	ne me laisses pas
man yi o	ne pars pas
mi man yi o	ne partez pas
wa fi	viens ici
wafi	viens ici
wa	viens
cɔ huiɖé	méfies-toi
tcho huiɖé	méfies-toi
tchɔ huiɖé	méfies-toi
un yi wan nu wé	je t'aime
un yi wan nuwé	je t'aime
un ɖo amisa sin ali ji	je suis en route pour l'église
un ko wa	je suis déjà arrivé
un kowa	je suis déjà arrivé
un ko wa	je suis déjà arrivée
un kowa	je suis déjà arrivée
é ko wa	il est déjà arrivé
é kowa	il est déjà arrivé
é ko wa	elle est déjà arrivée
é kowa	elle est déjà arrivée
un ko wa xwe gbe	je suis déjà arrivé à la maison
un kowa xwe gbe	je suis déjà arrivé à la maison
un ko wa xwe gbe	je suis déjà arrivée à la maison
un kowa xwe gbe	je suis déjà arrivée à la maison
é ko wa xwe gbe	il est déjà arrivé à la maison
é kowa xwe gbe	il est déjà arrivé à la maison
é ko wa xwe gbe	elle est déjà arrivée à la maison
é kowa xwe gbe	elle est déjà arrivée à la maison
un ko wa xwe gbe	je suis déjà rentré à la maison
un kowa xwe gbe	je suis déjà rentré à la maison
un ko wa xwe gbe	je suis déjà rentrée à la maison
un kowa xwe gbe	je suis déjà rentrée à la maison
é ko wa xwe gbe	il est déjà rentré à la maison
é kowa xwe gbe	il est déjà rentré à la maison
é ko wa xwe gbe	elle est déjà rentrée à la maison
é kowa xwe gbe	elle est déjà rentré eà la maison
etε wa wé	qu'est ce qui t'es arrivé
etε wa wé	qu'est ce qui t'es arrivée
etε wa mi	Qu'est ce qui vous est arrivés
etε wa mi	Qu'est ce qui vous est arrivées
go yiyi	égoisme
go yiyi tɔn sukpo din	son égoisme est trop
é jivi	elle a accouché
yé jivi	elles ont accouchées
mi do kpε	nous rendons grâce
mi ɖo kpε dido wε	nous rendons grâce
un do kpε	je rends grâce
un ɖo kpε dido wε	je rends grâce
mido kpε	nous rendons grâce
miɖo kpε dido wε	nous rendons grâce
undo kpε	je rends grâce
unɖo kpε dido wε	je rends grâce
nɔnvi cé	mon frère
nɔnvi cé	ma soeur
nɔnvi tché	mon frère
nɔnvi tché	ma soeur
ji gbe zan to wé ɖie nɔncé vivε	joyeux anniversaire maman chérie
ji gbe zan to wé ɖie tɔcé vivε	joyeux anniversaire papa chéri
ji gbe zan towé ɖie nɔncé vivε	joyeux anniversaire maman chérie
ji gbe zan towé ɖie tɔcé vivε	joyeux anniversaire papa chéri
jigbe zan to wé ɖie nɔncé vivε	joyeux anniversaire maman chérie
jigbe zan to wé ɖie tɔcé vivε	joyeux anniversaire papa chéri
jigbe zan towé ɖie nɔncé vivε	joyeux anniversaire maman chérie
jigbe zan towé ɖie tɔcé vivε	joyeux anniversaire papa chéri
jigbezan to wé ɖie nɔncé vivε	joyeux anniversaire maman chérie
jigbezan to wé ɖie tɔcé vivε	joyeux anniversaire papa chéri
jigbezan towé ɖie nɔncé vivε	joyeux anniversaire maman chérie
jigbezan towé ɖie tɔcé vivε	joyeux anniversaire papa chéri
ji gbe zan to wé ɖie nɔnvi	joyeux anniversaire frère
ji gbe zan to wé ɖie nɔnvi	joyeux anniversaire soeur
ji gbe zan to wé ɖie nɔnvi cé	joyeux anniversaire mon frère
ji gbe zan to wé ɖie nɔnvi cé	joyeux anniversaire ma soeur
ji gbe zan to wé ɖie nɔnvi tché	joyeux anniversaire mon frère
ji gbe zan to wé ɖie nɔnvi tché	joyeux anniversaire ma soeur
ji gbe zan towé ɖie nɔnvi	joyeux anniversaire frère
ji gbe zan towé ɖie nɔnvi	joyeux anniversaire soeur
ji gbe zan towé ɖie nɔnvi cé	joyeux anniversaire mon frère
ji gbe zan towé ɖie nɔnvi cé	joyeux anniversaire ma soeur
ji gbe zan towé ɖie nɔnvi tché	joyeux anniversaire mon frère
ji gbe zan towé ɖie nɔnvi tché	joyeux anniversaire ma soeur
jigbe zan to wé ɖie nɔnvi	joyeux anniversaire frère
jigbe zan to wé ɖie nɔnvi	joyeux anniversaire soeur
jigbe zan to wé ɖie nɔnvi cé	joyeux anniversaire mon frère
jigbe zan to wé ɖie nɔnvi cé	joyeux anniversaire ma soeur
jigbe zan to wé ɖie nɔnvi tché	joyeux anniversaire mon frère
jigbe zan to wé ɖie nɔnvi tché	joyeux anniversaire ma soeur
jigbe zan towé ɖie nɔnvi	joyeux anniversaire frère
jigbe zan towé ɖie nɔnvi	joyeux anniversaire soeur
jigbe zan towé ɖie nɔnvi cé	joyeux anniversaire mon frère
jigbe zan towé ɖie nɔnvi cé	joyeux anniversaire ma soeur
jigbe zan towé ɖie nɔnvi tché	joyeux anniversaire mon frère
jigbe zan towé ɖie nɔnvi tché	joyeux anniversaire ma soeur
jigbezan to wé ɖie nɔnvi	joyeux anniversaire frère
jigbezan to wé ɖie nɔnvi	joyeux anniversaire soeur
jigbezan to wé ɖie nɔnvi cé	joyeux anniversaire mon frère
jigbezan to wé ɖie nɔnvi cé	joyeux anniversaire ma soeur
jigbezan to wé ɖie nɔnvi tché	joyeux anniversaire mon frère
jigbezan to wé ɖie nɔnvi tché	joyeux anniversaire ma soeur
jigbezan towé ɖie nɔnvi	joyeux anniversaire frère
jigbezan towé ɖie nɔnvi	joyeux anniversaire soeur
jigbezan towé ɖie nɔnvi cé	joyeux anniversaire mon frère
jigbezan towé ɖie nɔnvi cé	joyeux anniversaire ma soeur
jigbezan towé ɖie nɔnvi tché	joyeux anniversaire mon frère
jigbezan towé ɖie nɔnvi tché	joyeux anniversaire ma soeur
ɖunu kpohun	manges seulement
ɖunu kpohoun	manges seulement
ɖounou kpohun	manges seulement
miɖi ɖunu kpohun	mangeons seulement
miɖi ɖunu kpohoun	mangeons seulement
miɖi ɖounou kpohun	mangeons seulement
wa miɖi ɖunu kpohun	mangeons seulement
wa miɖi ɖunu kpohoun	allons-y manger seulement
wa miɖi ɖounou kpohun	allons-y manger seulement
éya wa miɖi yi	ça y est allons-y
éya mi wa miɖi yi	ça y est allons-y
wa wazɔ xa mi	viens travailler avec moi
wa wazɔ xa mi	viens travailler avec nous
mi wa miɖi wazɔ ɖokpɔ	venez qu'on travaille ensemble
mi wa miɖu wazɔ ɖokpɔ	venez qu'on travaille ensemble
wa miɖi wazɔ ɖokpɔ	viens qu'on travaille ensemble
wa miɖu wazɔ ɖokpɔ	viens qu'on travaille ensemble
