sa sεn do wu	peindre
do sεn	peindre
sa adakpεn do	peindre une maison a chaux
kpεɖe kpεɖe	a
kpεviɖe	a
zinzin	a
kaka yi jε gan ɖe mε	a que
aɖi do mε	etre dans
wuvε	etre
do aɖi xomε nu mε	faire a quelquun
nu mε	faire a quelquun
ɖu kotokiti	donner
xo kan	donner
xo keve	donner
ku wu nu mε	peiner
ku wu nu mɛ	peiner quelquun
sεn	peinture
ajakatayaja ayakatayaja gudugudu guduu hannyahannya kpede kpede	pelemele
ɖe flo na	peler
fle han	peler
fle za	peler
kpa	peler
xasa	pelotonner du fil
flo	pelure
gbo flo	pelure dorange
jε kεn	etre penche
ɖo kεn	pencher
jε kεn	pencher
nya	pencher
nya do	pencher
gbεɖε	pencher cote
gban nya	pencher tete
si do	pencher tete
ze ɖo	pencher tete
si do	pencher
togbe	doreille
vodungbe mε	semaine
sa dayi	pendre jusqua terre
sa do ayi	pendre jusqua terre
do kan nu mε	pendre quelquun
gbεjε	qui
do kan	pendre
xo	penetrer lesprit profond propos
syεnsyεn	penible
vivε	penible
wu	etre penible
su hwε	faire penitence
su	faire penitence
nulinlin	pensee
tamεlinlin	pensee
lin nu	penser
vε do wε sin	penser
ɖo ayi ji	penser a
lin gudo	penser a lavenir
lin	penser a lavenir
lin sɔgudo	penser a lavenir
agblo	pente descendante
nya	etre pente descendante
agblɔnyinya	pente descendante
takwε yiyi	limpot
hwan	percer
ali	percer trou faire quelque
yi amlɔn	percevoir limpot
yi takwε	percevoir limpot
yi	percevoir limpot
atin	perche
ba	perche
kpogε	perche
kpotin	perche
bakε	celui qui manie perche dans une
akpla	perche cueillir les fruits
ɖo ji	etre perche
tunεkan	percuteur du
la mε	etre perdant
bu wun	perdre
εnε ɖo bu	perdre
ku aji	perdre a jeu calcul
ku aji	perdre au jeu daji
dan mε	perdre connaissance
nu	perdre connaissance
gu akwε	perdre largent
hu akwε nu mε	perdre largent a quelquun
vi ami	perdre lhuile
ɖi hun	perdre du
ahwan gble do mε	perdre guerre
ahwan gble do mε	perdre guerre
fle za	perdre peau plaie dessechee
ba nukunnu kpo	perdre vue
nukun	perdre vue
va nukun	perdre vue
gble ɖo mε si	perdre lamitie quelquun
gu mε	perdre le benefice
zan ku do mε	perdre le fil discours
va nukun	perdre les yeux
da	perdre alcool ou objet a ressort
fle han	perdre peau
xo to	perdre solidite fondamentale
xo to	perdre stabilite
sla	perdre
ci fo	perdre
sun aɖu	perdre une
fle	perdre une partie peau
asɔε	sorte perdrix
gble ɖo mε si	etre aux yeux quelquun
daa	pere
dεε	pere
asi asu	beaupere
daagbo daagbo dagbo	grandpere
mε	le pere quelquun
baba	le vieux pere
cacu	etre fait a
linfinyonu	pericarpe des graines
nukunmya	peril
nylado	peril
gble	etre perime
sa	etre perime
xlojun	detachee
hunjεvε	consacree au vaudoun
lankan	utilisee les femmes vaudoun
bebe	perles que les femmes au du
kolijε	perles qui au
kolijε	dessus du mollet
na gbe	permettre
nyi agban nu mε	permettre denvoyer a quelquun
tεgbε	perpetuellement
acukpa	perroquet
kisε	perroquet
kεsε	perroquet
kεsεklu	perroquet
ɖakpatɔ	perruquier
ɖe do mε	persecuter quelquun
jε go mε nu mε	persecuter quelquun
fεnfɔnumε	persecution
gomεjεnumε	persecution
mεɖedo	persecution
yadonumɛ	persecution
gandido	perseverance
gandudo	perseverance
linsyεnsyεn	perseverance
sundidε	perseverance
syεn lin	etre perseverant
xwe nu	etre perseverant
ɖo kan do wu	perseverer
gbeji	perseverer
nu ji	perseverer
ji	perseverer
syεn lin	perseverer
sin blublu	personnage
nyaɖaxo	personnage
mε nukun ɖe ji	personnage
mεdaxo	personnage
alufaa	personnage
mε	personnalite
mε	personne
mε ɖebu a	personne
mε ti a	personne
mε ti a	aucune personne
mεtun	personne
takunmε	personne et soi
mε sisε	personne adroite
mɛxo	personne agee
mε kpukpo	personne agee
mε xo	personne agee
mεkpikpo	personne agee
mεkpukpo	personne agee
mε ɖagbe	personne aimable
bomasin	personne atteinte delephantiasis
nuɖekpεnkan	personne au comportement choquant
nuɖegotego	personne au comportement choquant incivil
mε vɔvɔ	personne au teint clair
mεjεka	personne au teint clair
avɔkija	personne au
avɔkija	dessous
afɔlizen	personne ayant orteil releve et surmontant les autres
mε ɖagbe	personne bonne
mε fifa	personne
mεɖomεkpa	personne confiee a quelquun
nεsuxwe	personne consacree a nεsuxwe
sakpatasi	personne consacree a sakpata
aklɔnbεsi	personne consacree a vaudoun
avleketesi	personne consacree a vaudoun
lεgbasi	personne consacree a vaudoun
mawusi	personne consacree a vaudoun
maxinu	personne consacree a vaudoun
sakpatasi	personne consacree au vaudoun sakpata
awanvi	personne cour du
fɔnnu	personne lethnie
gεnnu	personne lethnie gεn
mεhwegli	personne
bibi	personne degourdie
hunɖote	personne destinee au vaudoun mais initiee
sakowungbe	personne devenue inattaquable
sakowungbe	personne devenue invulnerable
mεjɔmε	personne digne
mεjɔmε	personne distinguee
axisi	personne principale est daller au marche
mε xo	personne age venerable
mɛ wiwi cwicwi	personne debene
mε tlεlε	personne elancee
mεɖuaɖi	personne empoisonnee
mε mu	personne etrangere a groupe
mεxεnu	personne evanouie
mε sisε	personne
awumεnu	personne habillee
mεmaɖomεkannu	personne independante
hunsi	personne initiee au vaudoun
nuglonusu	personne irreformable
mε liyaliya	personne irrespectueuse
awumεnu	personne
kete	personne ou une le nom echappe
mε fifa	personne paisible
mεsegan	personne polie
mε bibi	personne prompte
mɛ dayi	personne prudente
awinya	personne puissante
kliboto	personne qui orteil releve au
kliboto	dessus des autres
gbangan	personne qui aime faire quelque qui depasse ses capacites
mεsegan	personne qui chante
mεsegan	personne qui danse
mεglεnsi	personne qui veut paraitre etrangere
mεglεnzin	personne qui veut paraitre etrangere
canu	personne quon nommer facon precise
mε bibi	personne rapide
bosu	personne riche malefices
mε sisε	personne rusee
avɔkija	personne
avɔsε	personne du couvent apres sejour
hwεmεsi	personne sous dependance
mε tlεlε	personne
mεklogan	personne tres distinguee
mεkloganklogan	personne tres distinguee
akwεnɔ hεjεkε	personne tres riche
mε ɖagbe	personne vertueuse
lisasi	personne vouee au culte vaudoun
lεnsusi	personne vouee au culte vaudoun
lεnsuxwesi	personne vouee au culte vaudoun
anagonu	personne vouee au culte sakpata
sakpatasi	personne vouee au culte sakpata
vodunsi	personne vouee au culte vaudoun
mεyaya	une personne ordinaire
nukunɖeji	une personne remarquable
takun ce mε	nom
bubu	perte
gu mε	avoir perte dans
nuxixe	perte connaissance
aɖusunsun	perte dents
nukunviva	perte vue
mε blublu	perturbateur
gblegble	perverti
mε gbigble	perverti
hun	etre perverti
hun sin	etre perverti
gble	pervertir
hεn gble	pervertir
gble mε	pervertir quelquun
kpinkpεn	pesant
kpεn	etre pesant
kpinkpεn	pesanteur
kpεn	peser
nyε	faire
nyε	peter
ɖo kpε	etre
ɖo kpεvi	etre
hwe	etre
hwe sin	etre
kpεkpε	a
ayidevu	dhomme
kpiwun	et constitue
klobwe	et
piwun	et solide
piwunpiwun	et solide
puwun	et solide
kwinεnkwinεn	qualifie etre et qui tient pas
kpεvi kpεvi	tres
kpεvi titi ɖe	tres
kpεvititi	tres
kpεvititin	tres
titi	tres
xisixisi	petitement
nyinya	petri
nya	petrir
nya linfin	petrir farine
nya	petrir terre
nya	petrir terre avec les pieds faire une
blu	petrir terre barre
nya linfin	petrir pate
kpεɖe	peu
tintin	peu
kpukpo	le fait detre peu cher
kpεɖe kpεɖe	peu a peu
gbawunjo	peu cher
kpɔcɔnu	peu cher
kpikpɔ	peu cher
azan ɖe majεmajε	peu apres
kpεɖe kpεɖe	tres peu
kpεkpε	tres peu
kpεvi tintin	tres peu
kpεvi titi ɖe	tres peu
kpεviɖe	tres peu
kpεvititi	tres peu
kpεvititin	tres peu
kpεkpε	peu
kpεviɖe	peu
kεɖε	peu
kεɖεε	peu
lagbesogbe	peu partout
laxwe	peu partout
kpεɖe swii	peu
kpεviɖe ciwun	peu
kpεvititi ɖe	peu
tiwun tiwun	peu
do	peur
jejeje	peur
ɖo adohu ji	avoir
ɖo adohu ji	peur
ɖi xεsi	avoir peur
hu ado	avoir peur
xesi mɛ ji	avoir peur
ɖi xɛsi do mɛ wu	avoir peur quelquun
ɖi xɛsi nu mɛ	avoir peur quelquun
ta wa	peur que hasard
taa	peur que hasard
do adohu ji	faire peur
do xεsi	faire peur
wu	faire peur
do xɛsi nu mɛ	faire peur a quelquun
wiwi	qui peut faire peur
nya bibi	qui peut faire peur aux enfants
ɖi xɛsi	etre peureux
afɔnyɔ e soxu nyi jan tanyɔ vlafo vlavo	peutetre
agluza gbemε	phacochere
gbegluza	phacochere
ɖo	du
xuta	mer
atinkεnsatɔ	pharmacien
amanɔ	pharmacien traditionnel
wemaɖiɖe	photographie
ɖe	photographier
ɖe fɔto	photographier
ɖe mε	photographier quelquun
acagbe	phrases a deux termes prononcees deux personnes differentes
nukunmε	physionomie
caqueter	piailler
kε	piailler
jiga	a deux bouts
akwεgan	piece dargent
akwεtawunga	piece centimes
akwε	piece monnaie
gankpεkpε	piece monnaie
gankwε	piece monnaie
dɔncimε	piece tissu offerte au defunt
akpo	piece detoffe complete
avɔkpo	piece detoffe yards
amasinxɔmε	piece ou lon stocke des medicaments
avɔɖiɖε	piece raccommodee
asa	au
lokosa	au du roko
afɔkpasunsunnu	essuie
afɔkpasunsunnu	pieds
afɔligbe	le du
busu	les pieds plats
afɔ lajaa	pieds enormes
fεca	piege fer
mɔtin	piege oiseaux
kpεn	pierre
awinya agidigbaja	grosse pierre
senukwεn	pierre a moudre
sefunnu	pierre avec laquelle retaille pierre meuliere
kεn	pierre a briquet
kεn	pierre a
se	pierre a moudre
so kpεn	pierre a tonnerre
hwe	pierre calcaire
awinya dodo	pierre fondation
awinyaxɔkwε	pierre
sokpεn	pierre du tonnerre
awinyaxɔkwε	pierre precieuse
mawusinsεn	piete
ki jo	pietiner
kpo	pieu
xwele	ramier
xwlee	ramier
gbagidikpotin	dinde
nyikpotin nyikpotun	dinde
so likun	du
so agu	ligname
xwe	piller une maison
nuvivε	piment
takin xaya	du piment reduit poudre
gbagbatakin	piment
gbatakin	piment et
baɖoji	piment et
basia	piment et
atakin winiwini	piment tres
takin winiwini	piment tres
atakin cɔkɔsu	piment et
atakin gaga	piment et
takin gaga	piment et
cɔkɔsu	sorte piment tres
yaɖayaɖa	tres pimente
aɖu	pinces des crustaces
fεn	avec les ongles
fεn	longuement
agege	pioche a une seule pointe
kun	piocher
kwin	pion le jeu
ajikwin	pion le jeu
kozɔkwε	terre cuite couleur brune
ajijaxa xa	porcepic
mε	piquer
su mε nukunmε	piquer lenvie des autres
xo to nu	piquer les bords tissu
atin ɖo te	piquer arbre terre
atin ɖo te	piquer poteau terre
numεmε	piqure
do nu mε	faire une piqure a quelquun
nyla hu	etre pire
kukumakwi	pire que le
nyi akpa	faire
ahoo	tant pis
nublawu	pitie
nublawukunumε	pitie
kεnklεεn	aie pitie
bla wu	avoir pitie quelquun
wu nu bla wu nu mε	avoir pitie quelquun
bla wu nu mε	faire pitie
manahεn	faire le pitre
ɖo tεn mε	a
gba	avoir une ecolier
jε mε	etre
sε	etre
sε do	faire
nu mɛ	faire a quelquun
agblo	degagee agglomeration
yεhwexɔli hεnnu	devant porte eglise
hεnnu	devant une
aximε	du marche
ayi fin	balayee depuis veille
ahwanpletεn	publique
nuzinzan	rejete laccouchement
do	aupres
tε aza	plafonner
jε agada	avoir une grande plaie
jε akpa	avoir une plaie
agada	grosse plaie qui guerit pas
nyεnyε	plaie entre les orteils champignons
gbogada	plaie inguerissable
cakpa	plaie a guerir resistant a tous les medicaments
fεnsutakpe	plaie longle du orteil
hwεjijε	le fait plaindre
ku nu bla wu nu mɛ	plaindre quelquun
do gbεvi han	plaindre
jε hwε nu mε	plaindre a quelquun
hunhun nu	plaindre
ayikungban	plaine
gbεvi	plainte
gbεviyiya	plainte
hwεjijε	plainte
nukun mε	plaire
jlo mε	plaire a quelquun
ko	plut au ciel que
da ayihun	plaisanter
ayihun xo	plaisanter
hwan	plaisanter
hwan mε wu	plaisanter
ɖo alisa xa mε	plaisanter avec quelquun
hwan mε wu	plaisanter avec quelquun
ayihundida	plaisanterie
nuhwinhwεn	plaisanterie
vε	plaise au ciel que
awajijε	plaisir
xomɛhunhun	plaisir
gbεvivi	les plaisirs
ɖe we	faire
lɔkpo	planche
ajito	variete planche jeu
dekan	palmiers a huile
gbafla	plante
gbagloma	plante
afɔkpakpamε	plante du
togba	plante a epineuse
atin	plante arbustive
gumagbo	plante au ressemblant au gombo et pareillement a faire gluante
kumasa	plante bulbeuse a fleurs couleur jaune orange
kuyomasa	plante bulbeuse a fleurs couleur jaune orange
danmalya	plante censee eloigner les serpents
gblangwe	plante epineuse
lokpo	plante grimpante les feuilles sont comestibles
amasu	plante medicinale
amasuma	plante medicinale
xweflu	plante medicinale apparentee a menthe que lon efficace contre les moustiques
kpɔvεwun	plante qui porte des epines et les feuilles apres choc
danwunkan	plante qui porte des epines et qui empeche le sapprocher
alomaklu	plante qui ressemble a amavivε
gbele	plante qui ressemble a amavivε
tetegungun	plante qui ressemble a xovε
dekinkanma	plante rampante utilisee aussi le
gbowunkajε	sorte plante epineuse les fruits sont comestibles et les feuilles recherchees guerir du paludisme
akpa	variete plante
anya	variete plante
agbegbe	variete plante rampante
asabwεsabwε	variete plante rampante
asɔbokan	variete plante rampante tres vivace
do te	ligname
tun ava	des pieux surmontes claie
tun	des pilotis une
jo mε do nyi finε	la quelquun
tun de	palmier
do kpa	une haie
kε awe	plastronner
kpacakpaca	et
kpabεε	etre
kpεbεε	etre
cε	haricots avec ligname et viande poulet
cεka	que lon offre au fa
kpabakpaba	tres
atɔxwε	construite pilotis
tε godo	circulaire
fatε	divinatoire le fa
tε	curviligne
tatε	metal
tε	le fa
atε	tresse tres
ɖeɖe	plein
gbagba	plein
keze ɖeɖe	plein jour
hwe mε	plein midi
hwe mε ciɖiɖi	plein midi
hwemε	plein
xu zan	pleine mer
xuzan mε	pleine mer
zan xoxo	pleine nuit
zan xoxo	pleine nuit
zan xwe te	pleine nuit
wu afɔ	pleine sante
gbε	etre plein
wu ya	plein dentrain
kpεn kpo	etre pleine
fεε	pleinement
ya avi	pleurer
do avi nu mε	faire pleurer quelquun
avi mɛ	faire pleurer quelquun
vi	pleurer a propos
aviyatɔ	pleurnicheur
avi	pleurs
ɖasin	pleurs
ji wli	pleuvoir
ɖe atan	pleuvoir a petites gouttes
gbo ala do	faire des plis le cou
ala	pli du cou
mla	du
xa asa	les jambes
fli zan	une natte
mla zan	une natte
ɖɔkpεn	peche
xwe ji do	faire plongeon
jε mε	plonger
tadonumε	le fait plonger dans une affaire
zin do ya	plonger dans le malheur
xwe ji do	plonger dans leau
lun do mε	plonger dedans
zin	plonger quelque
zin mɛ do ya	plonger quelquun dans le malheur
fε	ployer
xo ji	sous pluie
zo ji	pluie saison
gbadεndεn	pluie
fo	pluie et reguliere qui au mois daout saison seche
xweji	pluies grande saison
kεsεzan	caudale du perroquet
fun	doiseau
wematin wewlantin	porteplume
sun koklo	poulet
lε	du pluriel apres les noms adjectifs ou pronoms
hwe hu	etre que
nyla hu	etre vilain
kplokadiwun	jamais ca
hu	que
nabiɖe	plusieurs fois
awukpo	dhabit
awukpla	dhabit
bosu	dhabit
wemasinglo	plastique proteger ou cahier
gandanu	poids
dεnkpe	poignard
hεntεn	poignee
alɔkpaxwemε	une poignee
alɔfun hwa	jambe
tomεfun	loreille
awadamεfun	des aisselles
alɔfun	des bras
alɔfun hwa	des bras blancs
afɔfun	des jambes
awɔntinmεfun	du nez
sεlifun	poils du
alɔgusu	poing
cεε	a
ɖo na wε	etre le
ja gbe	etre le
kpa hle	etre le devenir mur
xwe	etre le partir
gbεɖε	etre le tomber
gba	etre le denfanter
azan	le le eleve
zan	le le eleve
hunjεn	pointe
ge	pointe des pieds
sεnufεnu	pointe du chiendent
gbata	qui tete comme une pointe
xwe	des lattes
ɖo kεn nu ji	quelque
ɖo nukun mε ji	quelquun
bεcwε	pointu
xwiɖi	etre pointu
ɖugo	poire a poudre
aziigokwin	pois chiche
aziin gokwin	pois chiche
aɖi	avoir
xwa	espece poisson riviere grosse
anwε	poisson
gagaɖo	poisson a gueule allongees et aux dents pointues tres tranchantes
aglo	poisson avec des nageoires munies piquants
glwe	poisson avec des nageoires munies piquants
sosoglwe	poisson avec des nageoires munies piquants
kpokun	poisson mer
gannumεhwevi	poisson
hwevi mu	poisson frais
hwe susɔ	poisson
gesu	poisson qui vit dans les eaux saumatres
sili	poisson respirant des branchies et des poumons
lanhunhwεn	poisson seche qui
cεkε	poissons possedant trois nageoires tres acerees
agbaja	sorte poisson
sosoglwe	sorte poisson avec des nageoires munies piquants
wetin	sorte poisson ressemblant au mulet
avunhwe	variete poisson
oglo	variete poisson
zɔzɔvi	variete poisson
atakun	poivre guinee
ɖiɖi	etre poli
si mε	etre poli
xɛsi	poltronnerie
animatlε	pommade
sεnza	pommade noire extraite civette quon utilise parfumerie
sa nusawu do	pommader
nyiglo	cannelle
nyigwle	cannelle
acɔkan	dadam
henji	pommelle
hɔnkpakpε	pommelle
kajutin	pommier
jɔhɔndonu kεkε	pompe a velo
hunkuku	ponderation
sɔxwixwe	ponderation
ɖo azin	pondre
yɛhwenɔ gan	pontife
gbo	porc
agluza	porc
hanvi	porc
agluzasisa	porc castre
ajija ajijagbowε	porcepic
agluzavi	porcelet
agluza wuto	porcherie
agluzakpo	porcherie
agluzawuto	porcherie
do ji	portant avec soi
hεnkεn	a porte
too	porte au superlatif limplacabilite du
kpakpalifwe	porte branches palmier tressees
tutu	a portee
tututu	a portee
alɔkplaɖotεn	a portee
gbatε	faire le portefaix
baba	ceux qui grands habits
do ga nu mε	linteret a quelquun
gbatε	des bagages moyennant salaire faire le portefaix
do afɔku	malchance
hεn	le hamac
hwε mε	plainte contre quelquun
zyan yonu	ses fesses saillie
ɖiɖa	tete
kpan	le
kpan vi	enfant le
do	pagne
do	une chaine
hεn agban	une
xwe ganza	une couronne
jε akpa	faire le cote quelquun
nyi ahwan	foule
nu do nu mε	garant quelquun disant quil pas commis faute laccuse
nu mε	garant quelquun disant quil pas commis faute laccuse
gbo gbe nu mε	garant quelquun
basahwε	porteur
bagbaɖatakin	porteur fouet
xo ganlin	faire des portions pate
ajacε xɔgbonu	portonovo
do gesi mε nu mε	faire le quelquun a autre
agudatomε	portugal
gbɔjε	faire une
kpadido	cloture
kpadudo	cloture
kpadido	palissade
kpadudo	palissade
xwe	etre pose
ɖo mlε	des lignes fond
do	dessus
ɖo nu wu	quelque
kε xɔ	toiture
ze ɖo mɛ ji	les quelquun
ɖo ayi	terre
ɖo ayikungban	terre
gba afin dayi	acte aux consequences irremediables
sle	objet poids quelque
hun	etre possede le vaudoun
ɖo	posseder
ɖo asi mεɖe	posseder
tiin	posseder
ɖo akwε	posseder largent
nyi nyibu	etre possesseur bovins
sin	indique
wlenwin	possibilite
xu	faire
hun kaka yi	faire
hun kaka wa	faire venir
dexɔmε	poste douane
bowunbowun	poste
gbavibowunbowun	poste
gudo	posterieurement
kpan	deuxieme terme lexpression
sinzεn	a eau
ahozεn	teinture
ganzεn	metal
nuɖazεn	terre
atakingannu	metallique le piment
takingannu	metallique le piment
tɔyizεn	a
giɖazεn	preparer pate farine mais
magbomε	potager
akawungo	potasse
gbokewun	potasse
kanmu	potasse
agbanhεntin	poteau
xɔdotin	poteau bois soutenir une
alijlεtin	poteau indicateur
kpɔbii	potele
kpɔbikpɔbi	tres potele
lisazεn	poterie vaudoun le culte vaudoun
ɖu	poudre a
yɛlosun	poudre arbre
ɖadonu	poudre
ɖu	poudre
kiloo	poudre noire et brillante que les femmes emploient souligner leurs cils
atin	poudre medicament traditionnel
atinlinfin	poudre qui du bois ronge insecte
ta nu mε	poudrer enjoliver
koklo wuto	poulailler
koklo xɔ mε	poulailler
yi koklo	au poulailler
kokloo	poule
koklosi	poule
avivɔfun bla mε	avoir poule
avivɔfun mε	avoir poule
fun	avoir poule
koklo kɔmalwe	poule au cou
koklo	poule aux plumes parsemees
koklo ajagble	poule aux plumes parsemees
koklo ayalakijε	poule avec des plumes a rebrousse
sonu	poule guinee
koklo kεɖεkεɖε	poule grasse et lourde
koklo ahogban	poule noire
koklo kpεnkun	poule tachetee
kokloo	poulet
koklo aɖɔwe	poulet
koklo wlanwlan	poulet tachete
koklosixwε	poulette
asi	pouliche
abunεka	poupee
amunε	poupee
tawun tɔn	vrai
takun ce mε	personne
bo na do	que
ta wa	que pas
kaka yi mavɔmavɔ	toujours
kugbegbεgbe	toujours
tεgbε yi	toujours
agluza	pourceau
glasema	pourpier
lee	pourquoi
wu	pourquoi
wutu	pourquoi
wutu	pourquoi
etε wu	pourquoi
etε	pourquoi
ɖo enε wutu	pourquoi
enε	pourquoi
nu e wu	pourquoi
nu e wutu	pourquoi
nu e wutu we	pourquoi
nyinyɔ	pourri
nyunyɔ	pourri
gbi	etre pourri
huhwε	etre pourri
vo	etre pourri
jε va	etre pourri parlant patate
huhwε	pourrir
jε va	pourrir
bla gba nu mε	poursuivre
xwe do mɛ	poursuivre
xwe nu	poursuivre obstinement
co	pourtant
vε	pourvu que
ko	pourvu que
kpikpe	pousser
sisε	pousser
sεn	pousser
kun	pousser
tun do	pousser
nya wa	pousser a venir
do axo	pousser grands cris
do axoxo	pousser grands cris
do caxoxooo	pousser grands cris
su caxoxoo	pousser grands cris
su caxoxooo	pousser grands cris
to	pousser grands cris
aɖu	pousser nouvelles dents
do ake	pousser des cris
kpa awobobo	pousser des cris joie frappant
kpa awobobo	pousser des cris joie frappant
fan	pousser des cris plaintifs
ɖu nyɔkwin	pousser des gemissements sourds
do	pousser porte
do nu mε	pousser quelquun a sendetter
ba xo mɛ	pousser quelquun dans ses retranchements
do xo	pousser cri
sε do	pousser
sε yi	pousser
afintuntun	poussiere
vun afuntuntun	faire poussiere
koklovi	poussin
agbanhεntin	poutre
kpo	poutre
azakpo	poutre du
atin	poutre medicinale faite avec des plantes
acε	pouvoir
acεkpikpa	pouvoir
kpe wu	pouvoir
tiin gan	avoir le pouvoir
ɖo asi mε	etre au pouvoir
ɖo acε mε	etre au pouvoir quelquun
e soxu nyi	il peut
ɖe hun	pratiquer une saignee
dε	precaution
do	precedemment
jε	preceder
sεn	precepte
jla xo	precher
kpitikpiti	precipitamment
kpitikpiti	avec precipitation
kpikpe	precipiter
nyi	precipiter
kpikpe mε sin ahoho ji	precipiter quelquun du haut des remparts
do	precipiter
zun do ji	precipiter
wla	precipiter des marchandises
wla	precipiter nourriture
do	precipiter vers
jεn	precisement
pεpεpε	tres precisement
ɖe na	preciser
nu	etre precoce
ɖayi	predire
ɖo ayi	predire
ɖo agbomε ji	dans sous prefecture dabomey
kpɔnla	sous
kpɔnla	prefecture
ketu	sous
ketu	prefecture au nord du departement loueme
kpe mε	etre le acheteur journee
kpan mε	etre le acheteur journee
kpe	etre le acheteur journee
mεxo	le ancetre
sεsu	le mari
sunwaji	le quartier
sosu	dinitie au vaudoun so
nukɔngbevi nukɔnvi	premierne
tεεtε	pas lenfant
kpodo	terme lexpression
hunɖezεxwε	premiere ceremonie
kplokplo	premiere et derniere fois
kplowun	premiere et derniere fois
sosi	premiere fille dinitie au vaudoun so
azɔn	premiere fois
sεla	premieres regles
do	premierement
wli	avoir une saveur prenante
mɛ do wu	quelquun comme soutien
do wu	quelquun consideration autre
gbo mε do	quelquun delit
do mε	ses jambes a cou
do ge mε	ses jambes a cou
xwe	ses precautions
kpe nukun wu	soin
bo	soin quelquun
hεn mε	soin quelquun
kpe nukun wu	soin veiller
vo	temps
xwe	temps
gbo do	le fait
nyla nukunmε	severe
lε fa	rituel
ali ji	chemin
jε ali ji	chemin
wli ali	chemin
vi	enfant poitrine
vi ɖo	enfant poitrine
vi	enfant les genoux
nu amasin	medicament
jε nyi	nom
gbla	peu nourriture
ɖu kwin	pion
wli ɖayi	propos au serieux
do hun	vehicule
da nu	une consideration
nu hεn do wu	une consideration
wu	une
wu	une savon eponge
do kun mε	une femme dans une famille bonne
kan	une pate
kan	une quelque
kan kpo	une partie du
ɖe foto	une
ɖe nu	une
do xomɛsla	une
nu xomɛsla	une
kpe nukun wu	pas soin
do ayi mε	a coeur
do gbatε	a gages
kiya	au serieux
kpla	avec soi
mε do nu wu	conseil quelquun quelque
ɖo azan nu mε	avec quelquun
wun	farine dans tas
wun	poussiere dans tas
ɖe hwεn nu mε	lavance lui
ɖe hwεn nu mε	lavance quelquun dans une tache quelconque
ba	leau
ba sin	leau
wun sin	leau
wu	lembonpoint
ɖe mε	dedans
ɖo mε	dedans
kpa sin	delicatement le dessus du liquide
kpa ami	delicatement lhuile palme a leau
ɖe ali	des chemins differents
nu	des choses une a une
yi kpamε	des soins proprete intime
lanmε	du
wun	du dans tas
wli hwevi	du poisson
wli kpo kpo	delit
da asi	femme
gbe yawo	femme
kpla asi	femme
wa asi nu	femme
yi asi	femme
do ayi	garde
nu nu vodun	bete ou laliment deja prepare et lemietter aux pieds du vaudoun
timati hwεkan	couleur tomate
yi mεsi	femme dautrui
yi mɛ asi	femme dautrui
kpa	fuite
gba gan	fuite prisonnier
mε tεn mε	quelquun
do jomεhun	lavion
fε do	le depart
lutu mε	le deuil
gbla	le gouter
fε do	le
ɖu gbada nu	le
nu vodun	le vaudoun a temoin
mε	les jambes a cou
do mε	lhabitude
da asu	mari
yi asu xwe	mari
do wu	modele
sa kan mε	quelque a quelquun qui pas paye dette
sa axi	quelque au marche
gbo sosi	quelque cachette le
gbidi nu mε	quelquun a
gbe nu mε	quelquun a
ɖe kpa mε	quelquun a lecart
mε ɖo te	quelquun a temoin
mɛ do wu	quelquun comme auxiliaire
sε nyikɔ	prenom
sεnyi	prenom
wεnnyi	prenom
azangbenyi	prenom correspondant au jour dans semaine
nugbomε	preoccupation
gbo mε	avoir des preoccupations
mya nukun	preoccupe
yaya	netre pas preoccupe
hεn hun nu mε	preoccuper
mya nukun	preoccuper
ɖo hun mε	preoccuper
kiya	preoccuper
blo ɖo	preparer
nu	preparer
sin	preparer certains recipients evidant linterieur
kpan anya	preparer puree
hiza lan	preparer viande
ɖa hun	preparer des
ɖa hun	proteger quelquun
gu	preparer des malefices
ɖa hun	preparer du loffrir au vaudoun
ɖa ɖu	preparer et
xo adan	preparer bouillie mais faire pate
xo koko	preparer bouillie mais boire
ɖo zan nu mɛ	preparer natte a quelquun
ɖa nu	preparer nourriture
ba	preparer pate gari
tε ba	preparer pate gari
ɖo tavo	preparer
jla ayi ɖo	preparer le
ji gali	preparer gari leau dessus
ahwannu	preparer le necessaire guerre
tε tavo ɖaxo	preparer festin
ɖa hun	preparer une ceremonie speciale
fun ma	preparer une espece aux feuilles legumes
ɖa	preparer une nourriture
bla agbaja	preparer a battre
bla akpa	preparer a battre
nu xwe	preparer
ɖibla	a peu pres
kεnnεkεnnε	pres
fi	pres
tofi	pres
tututu	pres
ɖo mε	pres
yɛsu	du fa concernant tel vaudoun
nunina	present
hwenu e mi ɖe	a present
nuwamεgbedomε	presentation des condoleances
xwixwle mawu	presentation des offrandes le a dieu
xwlexwle mawu	presentation des offrandes le a dieu
nuxwlexwle	presentation des offrandes a vaudoun
nuxlεxlε	presentation des pagnes au cours ceremonie funebre
nuɖe xwle mɛ	presenter
xwle nuɖe mɛ	presenter
kpla mε yi xlε mε	presenter une personne a une autre
kε	presenter les entrouvertes
do nuwamεgbe nu mε	presenter ses condoleances a quelquun
xo gbe	presenter ses hommages
bεli nu mε	presenter ses respects a quelquun
xo gbe	presenter ses respects a quelquun experimente
xo gbe	presenter ses respects a devancier
jo avalu mε	presenter ses respects a maitre
xo gbe	presenter ses respects a maitre
xo gbe	presenter ses respects a superieur
jo avalu mε	presenter ses respects a superieur
mɛɖee mɛ	presenter a quelquun
ɖo te	presenter a une pouvoir trop attendre
xwe	presenter inopinement
hwlen gan	preserver
benε	le president du benin
gbεnugan	president
ɖu gan	presider
ɖibla	presque
kεnnεkεnnε	presque
bla de ji	presque
vlivlivli	presque nuit
vlivli	presque
vlivlivli	presque
do	etre presse
vo	pas
ɖi	le pas
ɖi zɔnlin	le pas
ze	le pas
sin mε	faire sortir
jigan	faire sortir une chique
xo asan nu mɛ	quelquun obtenir une faveur
xo nu mε	quelquun obtenir une faveur
yovozεn	une
zin	pressurer
aceji	etre pret
gbe	etre pret
ya	etre pret
zin	etre pret a laccouplement
zin nε	etre pret a laccouplement
wuyamɛ	pret a laction
akwεnyanumε	pret dargent
akwεnyinya	pret dargent
nu	pret a tous les mauvais coups
enyii	pretend que
gangannagansu	pretentieux
gba va	faire le pretentieux
cejijεnnagboɖo	pretention
nunuklajε	pretention
sa akwε nu mε	preter a interet a quelquun
nya nuɖe nu mε	preter a quelquun
ɖo to te	preter
nya akwε nu mε	preter largent a quelquun
ɖo to	preter loreille
wli to wu	preter loreille a propos
hwe nu nu mε	preter quelque a quelquun
nuxayatu	preteur
badekanma	pretre du vaudoun bade
yɛhwenɔgan	pretre responsable paroisse
nu mε ɖayi	prevenir quelquun
nuglonu	preventif ou remede contre les effets nocif
nunywεɖayi	prevision
lin ɖayi	prevoir
tuwun ɖayi	prevoir
tuwun dayi	prevoir
tuwun ɖo ayi	prevoir
ɖo nuɖe sin kpasin	prevoir quelque
kpasin	prevoyance
lin sɔgudo	etre prevoyant
xo ɖε nu mε	quelquun
sa vo nu mε	quelquun
ɖεgbe	priere
ɖεxixo	priere
ɖεxuxo	priere
ki	faire priere parlant des musulmans
kantaɖugudoɖε kantaɖugudosinɖε	priere postcommunion
yɛhwexixa	priere vocale
kpɔnuwa	nom
ahwlikpɔnuwa	dabomey
ɖo ji	principalement
ɖotaji	principalement
sε	principe
asufanmε	prise contre le gre du proprietaire
fun	priser
sεn gan	faire
ganmεnu	prisonnier
gbawunjo	a vil prix
kpɔcɔnu	a vil prix
akwε	avoir du prix
kwε	avoir du prix
akwε	etre prix
kwε	etre prix
blo axi nu mε	faire prix a quelquun
nugbomε	probleme
gbo mε	avoir des problemes
hwεɖiɖɔ	procedure
hwε	proces
hwεɖiɖɔ	proces
mεnɔzo	prochain
ya	etre proche
sε	etre proche
sε mε	etre proche
sε ya	etre proche
kεnnεkεnnε	proche
tutu	proche
tututu	proche
ji	proclamer
jla xo	proclamer
xo mla mɛ	proclamer ses louanges
ɖo gbɔn tomε	proclamer edit
akwε gugu	prodigalite
akwεgugu	prodigalite
ayoɖuɖu	prodigalite
nuzandoyamε	prodigalite extreme
bojlεjlε	prodige
nu baɖabaɖa	prodige
nujijlε	prodige
nujiwu	prodige
nujlεjlε	prodige
hun bo	faire des prodiges
nuywε	prodigue
gu	prodiguer
do te	produire
ɖi	produire
si	produire fumee
sεn	produire des fruits
kεcεε	produire abondance
fyε	produire brulure
ji zo	produire brulure
ɖi	produire effet
ja	produire uniquement les fruits du palmier a huile
hwinhwan	qui produit comme le mais
ɖu su nu mawu	une sainte
adan	proferer des menaces
adan nu mε	proferer des menaces contre quelquun
ahwan	proferer des menaces guerre
sa bo	proferer une
sa bo gbe	proferer une
ɖu le	faire des profits
do nu wu	pas
do wu	pas
ta afu mε ɖu	quelquun
ɖu afu	aubaine
nyalinmε nyalinmε	profondement
gunmigunmi	profondeur
zunta	les profondeurs foret
nukɔnyiyi	progres
gbigbε	prohibe
kpasin	projet
ɖo nuɖe sin kpasin	faire le projet quelque
ɖe we	faire projet
dan hun	promener
ɖi sa	promener
akpa	promesse
do kpli	faire une promesse sous
kplidudo	faire une promesse sous
kpli	promesse sous
kpliɖiɖe	realisation promesse faite apres
do akpa	promettre
gliwun	promptement
mε lε	pronom
ε	remplace le pron pers personne e apres lelision voyelle ouverte
hwεɖiɖɔ	prononce
sa bogbe do mε	prononcer des paroles incantatoires contre quelquun
bo	prononcer des paroles magiques
sa bo	prononcer des paroles magiques
hwε	prononcer jugement
do nubyaxa	prononcer une memorable
ɖo hwε nu mε	prononcer une contre quelquun
bɔlu	prononcer une
funfun kpe	propager
funfun kpe	propager
amaxuxo	prophete
mεsεdo	prophete
wɛnsagun	prophete
ɖayi	prophetiser
ɖo ayi	prophetiser
gbevεsin	propos durs
gbevεsin	propos rudes
gbevεsin	propos secs
mimε	propre
wu	etre propre
zin wu	etre propre et soigneux
ceke	proprement
mimε	proprete
nyi lan	etre proprietaire du betail
agli	proprietaire acteur histoire
kpolijijε	prosterner
do do	prosterner
xwe do	prosterner
xwe su do	prosterner
nu	prosterner devant le
do do nu mε	prosterner devant quelquun
do do nu	prosterner devant quelquun baisant terre
ɖubalε	prosterner a ventre
ɖe nu mε	prosterner le contre terre devant quelquun
awungosu	prostituee fieffee
dan to	prostituer
lε aga	prostituer
nya to	prostituer
mε	etre le protecteur
jε gblolo mε	pas avoir protecteur
na	protecteur maison
nyi	proteger
nu	proteger quelque
ɖo mε ji	proteger quelquun
nu	proteger quelquun
mε ji	proteger quelquun quon decouvre pas
xε	proteger maladie faisant rites lempecher dy entrer
hwe	proteger du
anwε	poisson respirant des branchies et des poumons
sin	provenir
wa sin	provenir
xo logwelogwe	proverbe
ɖε wu	providentiellement
nu do	provoquer
ci te	provoquer
tε ji	provoquer
hihi wu	provoquer des demangeaisons
hu winnya gbo	provoquer honte
kpaca	provoquer le doute
do vε nu mε	provoquer linsomnie
ɖe do mε	provoquer quelquun
ba mε	provoquer quelquun
ba mεmε mε wu	provoquer quelquun
ba xo mɛ	provoquer quelquun
ba hun	provoquer quelquun a bagarre
ba hun mε	provoquer quelquun a bagarre
ba mε	provoquer quelquun a bataille
ba mε	provoquer quelquun a querelle
ɖe xo	provoquer avortement
ɖe xo nu mε	provoquer avortement a quelquun
mɛ	provoquer
do zo	provoquer incendie
sε do mε	provoquer une maladie contre quelquun
do mε	provoquer volontairement une maladie a quelquun
nukunyε	loeil
akinkɔntin	variete prunier
aɖuwusanga	glabre
ɖo gbɔn tomε	publier
gba xo ɖo	publier
gba xo kpe	publier
jla xo	publier des nouvelles
nuya nu mε	publier les miseres quelquun
ɖo weji	publiquement
jigan	penetrante
gusu	pugilat
dundun	puiser
dun	puiser dans puits
dun	puiser dans une
dun	puiser dans une riviere
xo sin	puiser leau
dun sin	puiser leau puits
wun sin	puiser leau recipient
dun sin	puiser leau citerne
dun sin	puiser leau
wun do	puiser finir remplir
wun	puiser remplir recipient
wun	puiser liquide dans recipient qui est a portee
ɖee	puisque
ɖo	puisque
kεnnεsi	et contre
kεnnεsi	attaque contre les sorciers
li	etre
tiin gege	pulluler
tiin su	pulluler
asan	pulpe lorange
to nu mε	punir
do ya nu mɛ	punir
ɖo hwε nu mε	punir
to nu mε	punir quelquun
ɖo hwε nu mε	punir quelquun
mεɖomεkpa	pupille
fɔngbe aku	fongbe
fεεn	tres
kpannya	puree
ayikunkpinkpan	puree haricots
anya	puree digname avec lhuile
mimε	purete
sεgbeji	dans purete originelle
amasu	purgatif
amasuma	purgatif
masinsla	purgatif
lεmεzo	purgatoire
lεmεzo mε	au purgatoire
do sla nu mε	quelquun
to	localite
nu hwε	toute iniquite
caklogosu	famille des dangbe
caogosu	famille des dangbe
donu εnε	le
tiwun	toute quantite
tiwun tiwun	toute quantite
tiwun	tres grande quantite
cεnwuncεnwun	tres quantite
kwin	quantite
alɔgogwe	quantite que les deux peuvent contenir
atεn	une quantite
goɖogoɖwe	une quantite
akwε hohun	une quantite dargent
alɔkpaxwi ɖe	une toute quantite
tintinviɖe	une toute quantite
alɔsεxwi	une tres quantite cacher les lignes
cεnwincεnwin	tres quantite
bayi	grande quantite
gbobli	grande quantite
gbogbo	grande quantite
kεcεε	grande quantite
tobutobu	grande quantite
wɔgɔo	grande quantite
gbidii	quantite
yaɖaɖa	quantite
yaɖayaɖa	quantite
akwε kanɖe	quarante cauris ou
kanɖe lisa	quarante et
degba wo	quarante
slaa mε	quartier
slaa mε	dans le quartier
fɔn slaa mε	le quartier des
gbεndo	quartier dabomey
akpafεn	quartier
ahwansla	quartier larmee
singbomε	quartier ouidah
agblomε	quartier situe au
agblomε	ouest abomey
gbεkɔn hunli	quartier dabomey
gbεkɔn xwegbo	quartier dabomey
akwε afɔwe	cents cauris ou
akwε degba	cauris
kanwe	vingts
kanwe wo	vingt
kanwe wo	dix
ɖee	que
to	est que est que
ahoo	que sais
ahoo	je
etε	quelle
nahun	quelle espece
tε	quel
nahun	quel au juste
akoba tε ɖie	quel malheur
tε	quelle
ɖebu	quelconque
hweɖenu	quelconque
fun mε	faire voir quelquun
fi ɖe	quelque
kaka azan ɖe na jε	quelque temps apres
mε nabiɖe nabiɖe weɖe	quelquesuns
mε ɖe	quelquun
memu	quelquun qui faisait pas partie du groupe
nabiɖe	quelquefois
nu	quemander
avɔkangbεtin	quenouille
hwεgbe	querelle
jlε	querelle
jlε	quereller
ba nu mε	quereller avec quelquun
mε	personne il ete
kan	questionner
kan mε	questionner quelquun
kan nuɖe mε	questionner quelquun quelque
xwe gbe	quete
gbo	faire quete des funerailles le cercueil
akwε	queter
kwε	queter
nu	queter
ɖe jε ɖe gudo	a
nyibusi	boeuf
va	des oiseaux et des poissons
ɖee	qui
aceji	etre le qui
mε ɖe a	quiconque
kete	quidam
azan ɖo sunzan mε	le quinzieme jour du mois
asi	femme
sin	endroit
anyi	quoi
ani o	quoi
eo	quoi
nu tε	quoi
tε	quoi
taansin	quoi
tantansin	quoi
o	quoi donc
ɖekpo	rabais
ɖiɖekpo	rabais
kpɔcɔnu	au rabais
ɖe axi kpo	faire rabais
tε ɖa	rabattre les cheveux
piwunpiwun	rable
atinxwlεnu	rabot
nuxwlenu	rabot
atin	raboter
kacakaca	raboteux
kejekeje	rabougri
avɔɖiɖε	raccommodage
kpikpe	raccommodage
nuɖiɖε	raccommodage
ɖiɖε	raccommoder
fε nu mε	raccompagner quelquun
nyi mε	raccompagner visiteur
blo ni ɖi ga	raccourcir
blo ni hwe gli	raccourcir
ɖe gaɖiɖi kpo	raccourcir
bεli	raccourci
kun	etre bonne
nyla kun	etre mauvaise
doko	racines familiales personne
fle	racler
kinkεn	racler
xwlε anyu	racler peau brulee ou ebouillantee
jaxwlε	raclure
gijaxwlε	raclure pate farine mais
blo ɖo	raccommoder
kpi	raconter
wli	raconter
tankpikpi	le fait raconter avec les histoires du temps jadis
tankpikpi	le fait raconter les secrets propre famille
ba nuɖe	raconter des boniments
kpa xo	raconter des histoires
cyan nu	raconter detail une
xogle	raconter une histoire dans tous ses details
bi	rafler
sa kan mε	rafler quelque
fa mε	rafraichir
fa	etre rafraichissant
fa mε	etre rafraichissant
kpinkpan	ragout
syεn kan	etre raide
slamε mε wu	railler
slamε mε wu	railler quelquun
mεkiko	raillerie
mεkuko	raillerie
nyɔmε	raillerie
ayihungan	rails
adinbese	rainette
ɖo hwεjijɔ	avoir raison
hwε	avoir raison
nu e wu we zan ba	raison laquelle
kpo	ralentir marche
wezun	ramasser
cyan kple	ramasser
kple	ramasser
xo kple	ramasser
akwε	ramasser largent
wla axi	ramasser des choses au marche
amaga	ramasser des mangues terre
cyan	ramasser des
ba naki	ramasser du bois
cyan nu	ramasser du bois
naki	ramasser du bois
wun gbade	ramasser du bois
sa wun	ramasser furtivement
su	ramasser
kple nukun	ramasser le
gbε ayikun	ramasser les haricots
cyan nuɖuɖu kpεvi kpεvi	ramasser les miettes
cyan nuɖuɖu winiwini	ramasser les miettes
agban	ramasser ses affaires
cyan	ramasser a
cyan de	ramasser une a une les cerises palme
dezan	rameau palmier
azan	rameau epanoui
kpla wa	ramener
lε kpla wa	ramener
ɖo	ramener a lunite
wun	ramener les jambes vers soi lorsquon est terre
wun	ramener vers soi
kun hun	ramer
kun tɔjihun	ramer
kun	ramer
vuvo	ramolli
nyi	etre ramolli
wu nu mε	ramollir
ɖa	ramure des arbres
kεn	rancune
kεn	rancune
nuhεnxomε	rancune
kεnbiba	le fait chercher rancune
nu xwe	ses affaires
nuwli kanlin	rapace
nuxwlenu	rape
fεnnyεnligan	rape a
kpakpa	raper langue
adɔvi	raper une chambre a
bi	etre rapide
ya	etre rapide
klaxla	rapidement
klewun	rapidement
kplakpla	rapidement
lewunlewun	rapidement
nyεwun	tres rapidement
yewun	tres rapidement
kplakpla	rapidite
yiya	rapidite
wa	rappeler
flin nu mε	rappeler quelque a quelquun
flin sεn mε	rappeler ordre a quelquun
flin sεn mε	rappeler une loi a quelquun
flin sɔgudo	rappeler le passe
flin nu	rappeler quelque
mε	etre agreable
vivi ha	etre agreable
kpa xo do mε	faire faux rapports quelquun
do ajan mε	faire faux quelquun
mε nu	rapporter
mε xo	rapporter
wa	rapporter
akwε ji vi	rapporter interet
hεn le wa nu mε	rapporter interet
ze nu wa	rapporter objet
hεn bɔ	rapprocher
ca	rapprocher deux choses
ca	rapprocher deux personnes
do	rapprocher les extremites
sε	rapprocher
sε mε	rapprocher
sε do mεɖee wu	rapprocher
ɖa	tete
atanxwlεha	rasoir
atanxwlεjivi	rasoir
atanxwlεnu	rasoir
xo	etre rassasie
kpikple	rassemblement
kplekple	rassemblement
mεkplekple	rassemblement
tasεkple	rassemblement
cyan kple	rassembler
kple	rassembler
kpli	rassembler
sε kple	rassembler
da ahwan	rassembler beaucoup monde
da ahwan	rassembler des troupes
ɖa	rassembler les cheveux ou plusieurs faisceaux au sommet tete
kpe do	rassembler les deux parties calebasse
kuku nu	rassembler les herbes coupees
gun ɖa	rassembler les tresses des cheveux
kple do	rassembler
de	etre rassis
ayi jε do	etre rassure
na jiɖe mε	rassurer quelquun
ɖɔfin	au ventre
gbeja	des champs
awlegbε	sorte brousse
ajakaja	ratiere
linsinlinsin	facon rationnelle
bla	rattacher
nya wli	rattraper
su	rattraper quelquun
fan asu mε wu	ravir
kpaca	ravir
xo	ravir
zinzin akpa	raviver douleur plaie
sεnwlεεn	raye
gbidi	rayer
xwi do nu ji	rayer
sεda	rayonne
ɖi wun	rayonner
hwεkan	rayure
tin tamε	pas reagir
jε	realiser
ɖiɖi	realiser
aɖi	qui sest realise
ɖe akpa	realiser une promesse
cε	realiser
ɖi	realiser
to	rebord
agwε	a rebours
jo	rebrousser chemin
azan vi lε mε	recemment
azanmεfi	recemment
kεnɖiɖe	recensement
mεxixa	recensement
xa mɛ	faire recensement
ɖe kεn	recenser
kεn	recenser
dekeje	les receptacles des noix dans le regime palme
fagban	receptacle du fa
yi gbe	a une reception
te fa	recevoir derniere au culte fa
tε fa	recevoir derniere au culte fa
yi fa	recevoir premiere au culte fa
sεn fa	recevoir premiere au fa au ladolescence
tε fa	recevoir le genie
ba mε	recevoir quelquun
yi mɛ	recevoir quelquun
yi kanta	recevoir
xε mε	recevoir hote avec tous les honneurs
yi	recevoir visiteur
yi ɖe	recevoir une recompense
xo ɖixo	recevoir une
se	sens general recevoir
gan	rechapper
zo do	rechauffer
xu	rechauffer
xu zo	rechauffer
xu	rechauffer aupres du
xu zo	rechauffer aupres du
xo zo	rechauffer poitrine
ɖo mε gbe mε	etre a quelquun
do asi nu mε	faire des recherches quelquun
ba mε	rechercher
keje	rechercher
ba mεmε mε	rechercher sympathie quelquun
ba mεmε mε wu	rechercher sympathie quelquun
nya gbe	rechercher quelquun qui sest echappe
nuhεnnu	recipient
aglovi	recipient puiser leau
gannu klobotoo	recipient metallique
sinnukpanu	recipient metallique boire leau
nujlεgannu	recipient metallique mesure
ataɖagban	recipient faire frire les beignets haricots
sinxwizεn	recipient le filtre
jlεgannu	recipient mesurer
sinhεnnu	recipient destine a contenir leau
kpanu	recipient tole
yɛhwexixa	recitation priere
xa yɛhwe	reciter des prieres
nujlajla	reclame
to	reclasser
nukunyiya	recolte
aziinkunkun	recolte darachide
gbadefinfεn	recolte mais
gbadeyiya	recolte mais
agbafinfεn	recolte mais
ayikungbigbε	recolte des haricots
ya jinukun	recolter
gbε nukun	recolter
ya nukun	recolter des graines
nukun	recolter des haricots
kun	recolter des tubercules quon peut ramasser quen creusant
ɖe avɔkan	recolter du coton
kun aziin	recolter larachide lorsque terre est
fεn gbade	recolter le mais
atan	recolter le vin palme
ze mε do alo mε nu mε	recommander
ze mɛ do nu mɛ	recommander une personne a quelquun
na mε	recompenser quelquun
xa	recompter
hwεgbɔdido	reconciliation
hwεgbɔdudo	reconciliation
ɖa hun	reconcilier
ɖa hun nu mε	reconcilier
hwε gbo	reconcilier
hwε nu mε	reconcilier
do hwε nu mε	reconcilier quelquun
lε su	reconcilier quelquun avec le vaudoun apres interdit
do hwε nu mε	reconcilier quelquun avec autre
de hwe gba xa	reconcilier avec quelquun
do hwε xa mε	reconcilier avec quelquun
kεn xa mε	reconcilier avec quelquun
kpla mε hεn yi	reconduire
kpla mε yi	reconduire
ɖo mε	reconduire
nyi mε	reconduire visiteur
do wu mε nu mε	reconforter quelquun
do wu nu mɛ	reconforter quelquun
nunywεnumε	envers quelquun
nutuwunnumε	envers quelquun
tuwun ɖagbe	etre reconnaissant
nywε nu mε	etre reconnaissant envers quelquun
tuwun ɖagbe nu mε	etre reconnaissant envers quelquun
tuwun nu mε	etre reconnaissant envers quelquun
yi	reconnaitre delicatesse quelquun
tuwun mε nu	reconnaitre quelque
ɖo ayi mε ji	reconnaitre quelquun
tuwun mε	reconnaitre quelquun
yi gbe	reconnaitre culpabilite
yi gbe	reconnaitre ses torts
lε gba	reconstruire une maison
gban	etre recourbe
gban	recourber
wa su mε	avoir recours a quelquun
yi su	avoir recours a quelquun
gan	recouvrer sante
va	recouvrir
nu mε	recouvrir quelquun pagne
ayihunda hwεnu	recreation
gbɔjεhwenu	recreation
hwε	recreation
ɖo	compte
axiwema	recu taxe quand au marche
do do	recueillir
do do	recueillir reflechir
jo wa gudo	reculer
jo yi gudo	reculer
sε yi gudo	reculer
yi gudo	reculer
gudagwε	a reculons
mε	recurer puits
xwa	recurer puits
wa do	redescendre
yi do	redescendre
kuzu	redevance annuelle
kεn	redevance annuelle que le fermier paye au proprietaire
makanɖekpo	rien a redire
van kan do nu wu	deffort quelque
sisi	redoutable
ɖi xεsi	redouter
ɖe kpo	reduire
hεn kija	reduire quelque ses elements
do nu mɛ	reduire quelquun faim
huzu afin	etre reduit cendres
cicε	reduit frauduleusement
jεn	reellement
ɖo	refaire le tas
do	refermer
ku hun	reflechi
do ayi mε	reflechir
kan ayi	reflechir
keje tamε	reflechir
lin tamε	reflechir
lin tamε	reflechir
sa	agir reflechir
do nukun mε	reflechir a
lin tamε do nu wu	reflechir a quelque
do ayi do	reflechir profondement
xo su	faire des mouvements reflexes dans le sommeil
nyεɖee	reflexif
nyεɖee	reflexive
nulinlin	reflexion
tamεlinlin	reflexion
fa do mε wu	refroidir quelquun
hwla	refugier
bε	refugier a
wa su mε	refugier aupres quelquun
yi su	refugier aupres quelquun
gbigbε	refus
nugbigbε	refus
owo	particule exprimant le refus
mawugbigbε	refus dieu
tin	repondre
zo	mettre marche
gba gbe ala	decouter qui que soit
nu mε	detre agreable a quelquun
mεmε mε	compagnie quelquun
mεmε	lamitie
tε nuɖe mε	quelque a quelquun
gbe	qui vient detre
xwe	daller a maison
kpo ɖo	darreter
kpo	ralentissant volontairement
nu mε	rendre a quelquun
si	au
kεn	rancunier
fin	a derobee
fin nu	a derobee
ɖo nukun te	attentivement
tlitli	avec
ji	haut
mε tlitli	quelquun avec insistance
mɛ	quelquun travers
mε xaan	quelquun dur
mɛ	quelquun le menacant
do wu nu mε	quelquun lui faisant comprendre quon remarque ses agissements
nu	groupe musique
kpan	vers
kpan	a
nukpεn	dans
we	dans miroir
kpo azan	avoir regimes
kpo	avoir regimes
kwekwe hwin	regime bananes
hwin	regime fruits
viɖokpokanta	regime mariage qui est une attenuee lechange des femmes
de hwin	regime noix palme
kankansun	regime palme enleve les amandes
kpokanta	regime special mariage
kanmε	region
tomε	region
hun	designant region dabomey dans certaines expressions
tamε	region tete
tokpa	region loreille
tomε	region loreille
nyɔmε	region des gencives
alinmε	region des
ci	region du
sεli	region du bassin
hungomε	region du coeur
he	region du situee sous machoire
alinkan	region lombaire
akwεwema	registre compte
ɖo hun mε	avoir ses regles
ɖo mε	avoir ses regles
jε glegbe	avoir ses regles
jε la	avoir ses regles
jε nu gudo	avoir ses regles
jε nugudo	avoir ses regles
sun	avoir ses regles
kpa	avoir ses regles
ɖo gbe ji	etre regle
ɖo sεn ji	etre regle
sεla	les premieres regles
sunmεnu	les regles
sεn	reglement
adɔn gεnnyigεnnyi	affaire a regler
do xo mε nu mɛ	regler une affaire quelquun
akwε	regler ses comptes
su mε	regler une dette a quelquun
jεmaɖi	regles interminables
ɖu	regner
jε mε do	quelquun
jε nu do	quelquun
avaji	le regroupement des zangbeto apres des manifestations
akunvlamε	des
jε mε ji	rejaillir
fε gba mε	rejaillir quelquun
nyi	rejeter
nyε	rejeter
se ɖo	rejeter
mla hwε	rejeter jugement
sa heelu	rejeter le malheur quelquun
vi	rejeter liquide
aɖivi	rejeton arbre
xu ji	rejoindre
xwe do mɛ wu	rejoindre quelquun
gba wu	rejouir
hun	rejouir
jawa	rejouir
jε awa	rejouir
awajijε	rejouissance
xomɛhunhun	rejouissance
jo do	relacher
jo mε nyi te	relacher quelquun
ɔ	les propositions relatives
xo xa mε	etre avec quelquun
gba	une fille
busu	orteil releve
xwe te	relever
si te	relever
do aga	relever
tecici	laction relever
gla awa	relever les bras faire limportant
sεkanta	religieux
xa	relire
nukunɖeji	remarquable
ɖo nukun mε ji	remarquer
kεn	remarquer
ɖo kεn ji	remarquer quelque
ɖo kεn nu ji	remarquer quelque
ɖo nukun ji	remarquer quelque ou quelquun
jo akwε	rembourser
su mε	rembourser
atinkεn	remede comprimes
nudolanmε	toutes sortes remedes
kpε	remerciement
kpεdido	remerciement
kpεdudo	remerciement
do kpε nu mε	remercier quelquun
do ku nu mε	remercier quelquun
do ku nu mε ɖo nu ɖe wu	remercier quelquun quelque
jo	remettre
jo nu mε	remettre
kε	remettre
ze jo nu mɛ	remettre
lilε ɖo	remettre a tard
ze mɛ	remettre a quelquun
xwe te	remettre debout
lε ɖo te	remettre debout
to	remettre ordre
na agban nu mε	remettre a quelquun
zo do	remettre le
kε mε	remettre une dette a quelquun
ze kε mε	remettre une dette a quelquun
kpla mε hεn yi	remmener
kpla mε yi	remmener
hεn yi	remmener
sε do aga	remmener
na kan	remonter
na kan	remonter une corde
na kan gan	remonter une montre
na	remonter une montre
nuvivε	remords
ayi xo hun xa mε	avoir du remords
mε	remplacer
jε mε tεn mε	remplacer
tεn mε nu mε	remplacer
mε tεn mε	remplacer
gbagba	rempli jusquau
gba kpe	remplir
wun	remplir
ɖo gan	remplir loffice crieur
gbe	remplir mauvaise herbe
xo zin	remplir
ba sin	remplir deau
yi	remporter
ɖu ahwan ji	remporter guerre
ɖu ahwan ji	remporter victoire
mlamla	remuant
nu	etre remuant
ɖu	remuer
hεn dan	remuer
xo	remuer
dan xasaa	remuer
ɖaɖa	remuer et faire tourner tous sens
vun	remuer pate avec
dan	remuer pate le
jije ayikungban	remuer terre
hunhun	remuer tete
hunhun ayi	remuer le coeur
ki jo	remuer les pieds
gbo wunda	remuer les sourcils
ya wu	remuer
ayisajε	renard
jε	renard
jεxisa	renard
kpe	a
yi kpe mε	a quelquun
kpe nu	faire une effrayante ou mauvais augure
nu kpikpe	deux choses
mεkpikpe	deux personnes
nu kpikpe	personne avec
nukpikpe	personne avec
mε kpikpe	entre deux personnes
kudan	fatale
ɖu	rencontrer
kpe	rencontrer
kpe ka	rencontrer quelquun
kpe nu	rencontrer fantome
do go	rencontrer
kpe go	rencontrer
xo go	rencontrer
kpe xo xa sunnu	avoir rendez
kpe xo xa sunnu	vous avec homme
kpe xo xa	avoir rendez
kpe xo xa	vous avec une femme
jo	rendre
jijo	rendre
jo nu mε	rendre a quelquun
ze jo nu mɛ	rendre a quelquun
gεdε	rendre complique
ɖo gbe nu	rendre compte a quelquun
akwε	rendre des comptes
blo ni	rendre
ɖo	rendre
do xo	rendre enceinte
do ku nu mε	rendre graces a
jo avalu mε	rendre hommage
xo gbe	rendre hommage
jo avalu nu mε	rendre hommage a quelquun
nyi avalu mε	rendre hommage a quelquun
mɛ	rendre hommage a quelquun
lu	rendre
do hwejijɔ nu mε	rendre a quelquun
gbo hwε nu mε	rendre
ɖo nu mε	rendre malade
hεn	rendre
do mε	rendre quelquun malade
do xo nu mε	rendre quelquune enceinte
do mε	rendre a quelquun
gεdε	rendre tortueux
blu	rendre
na	rendre culte au vaudoun fecondite
xε na	rendre culte aux na leur offrant a
hun bo	rendre inefficace
ba	rendre
nu do mε	rendre a quelquun
jo mεɖee nu mε	rendre a quelquun
jo amisa nu mε	rendre chez celui qui commande une
nu mɛ wu	rendre coupable
ɖido	rendre dans
ɖu gan	rendre maitre
gbata	qui tete renflee
blo ni syεn	renforcer
na syεnsyεn	renforcer
kpiɖikpiɖi	idee renforcement
alɔgigo	renfort
alɔgugo	renfort
nyla nukunmε	avoir une renfrognee
nukunmε	renfrogner
nyla nukun mε	renfrogner
zyan	rengorger
mεgbigbε	reniement
mεmεgbεmε	le fait renier familiarite avec quelquun
mε	renier quelquun
mεmε mε	renier quelquun
sε misin do	renifler
alaga	renseignement
winni	renseignement le quelquun
kpi tan	renseigner avec les faits vecus
agbotohayahaya	a
flijε	renversement
fli jε	renverser
fli xwe	renverser
gba dεεn	renverser separpillant
huzu xwe	renverser contre terre
fan	renverser
fli gba	renverser
gba	renverser
huzu	renverser
mu zin do ayi	renverser
mu zin dε	renverser
viva	renverser
xwe	renverser
zin	renverser
zin do ayi	renverser
gba sin	renverser leau
mu	renverser une
sε do	renvoyer
nya	renvoyer
nya sε do	renvoyer
nyi	renvoyer
tun	renvoyer fumee
tun	renvoyer fumee ou les narines
le nu nu sε do	renvoyer quelque
vuvɔjɔ	reorganisation
funfun kpe	repandre
funfun kpe	repandre
gba	repandre
gba do	repandre
gba nyi	repandre
hinhεn	repandre
nyi	repandre
sisa	repandre
hlεnhlεn	repandre
do vε	repandre farine devant le ou reside vaudoun
do akutu	repandre farine le legba
gba sin	repandre leau
gba dεndεn	repandre fines gouttelettes
gba fun	repandre les plumes
gba do ayi	repandre terre
gba gbe	repandre
gba kpe	repandre
tun fla	repandre
vun gba	repandre
vun kpe	repandre
sa vo nu mε	repandre doleances
gba dεnɖεn	repandre fines gouttelettes
hannya	repandre morceaux
sa kpe ayikungban	etre repandu terre
do	reparation
do	faire reparation
blo ɖo	reparer
jla	reparer
jla ɖo	reparer
lε ɖo te	reparer
afɔkpa	reparer des chaussures
yi	repartir
gba	faire le repas qui clot une ceremonie vaudoun
kantamimε	le repas eucharistique
hunmεxwlε	repas qui clot une ceremonie
li	du
xwise	une fois farine dans le
hwεvεnumε	repentir
nuvivε	repentir
nuvεnumε	repentir
hwε vε nu mε	repentir
hankpa	repetition
kan tun	repiquer
wun	les jambes
yi gbe	repondre
yi gbe nu mɛ	repondre
yi gbe	repondre a une
zunta nyi ga	repondre au hasard
cya	repondre avec appel
kpe nukun wu	repondre
sɔ	repondre quon entendu
zunta nyi ga	repondre reflechir
gbeyiyi	reponse
we	reponse a une difficulte
flijε	reponse contraire
gbeta	reponse fixe
flijε	reponse opposee
gbɔjε	repos
gbigbɔjε	repos
gbugbɔjε	repos
ayimimlɔ	repos
ɔ	a voix avant le discours
wu	repousser
sisε	repousser
tun	repousser
tun mε	repousser quelquun
wli	reprendre
yi nu sin mɛ asi	reprendre que lon donne
yi sin mε asi	reprendre que lon donne
yi han	reprendre le
do ayi do	reprendre ses esprits
ɖo te	representer quelquun
mε tεn mε	representer quelquun
mε sin ɖo te	representer quelquun
fεnfɔnumε	reprimande
nu nu mε	faire des reproches a quelquun
mεɖedo	reproches constants et justifies
nu do nu wu nu mε	reprocher quelque a quelquun
kε do nu wu nu mε	reprocher quelque a quelquun
tɔlo	africain appele couramment caiman ou
lo	africain appele couramment caiman ou
asigbibe	repudiation
gbε asi	repudier femme
asi	repudier femme
hεn	repugner
wu	repugner
kpasin	reserve
ɖo ayi	reserver
hεn ɖayi	reserver
hεn ɖo te	reserver
gbo hwla	reserver une soi
mε ɖo te nu mε	reserver une personne une autre
ci	resider
kpe	residu lhuile
amija	residu lhuile palme
ja	residu pate riz etc qui reste colle au fond recipient
alolyan	residu
alolyan	apres du bois
aliyan	residu ou bois ecrase
delyan	residu filamenteux partie charnue qui enveloppe lamande palme lorsquon lhuile
sundidε	resistance
glo	idee resistance
syεnsyεn	resistant
dε	etre resistant
lo	etre resistant
syεn	etre resistant
syεn da	etre resistant
dε	resister
dε sun	resister
syεn	resister
tun te	resister
ji	resister aux intemperies
ɖi	resonner
ɖi gbe	resonner
flan hun	faire resonner le annoncer que lon va a jouer
jε gbe	resonner
xo gbo	resoudre une affaire
ɖe nu mε	jeter terre le et les epaules le present
sisi	respecte
gba acε	pas
nyi sεn	loi
si mε	quelquun
gbɔjε	respirer
xii	respirer comme asthmatique
agbanɖotananɔ	responsable
ɖo mε	etre responsable
mεnugan	responsable groupe
gbo mεɖe fan	ressaisir
ɖi	ressembler
ɖiɖi	ressembler
ɖɔhun	ressembler a
ci nuɖe	ressembler a quelque
ɖi mε	ressembler a quelquun
kεn	ressentiment
xomɛsin	ressentiment
kple yo	avoir les cuisses tres resserrees
kpli yo	avoir les cuisses tres resserrees
bla ji	resserrer
bla xo mε wu	resserrer
da	avoir ressort
jla ɖo	restaurer
lε ɖo te	restaurer
kpukpo	reste
nu kpukpo	reste
kpikpo	reste
kpo lε kpan	avec les
atan fin	avec les bave nuit
kpe kpo	etre reste
kpo	etre reste
ɖukpo	reste nourriture
kankpo	reste pate
tε	a cours dexplication
tε	a darguments
jε we	a decouvert
ci vo	a lecart
xo yonu zo	longtemps
xu hwe	au
xu	au
hun jεε	bee
xwe	calme
ci gudo	derriere
ɖo kεn xa mε	etat dinimitie avec quelquun
wunzεn	eveille
xo zan	eveille
gbeji	fidele
ci	inerte
kpo	invendu
nu mε	quelquun
cuu	pensif
ci cuɖuɖu	bouger
ci tii	mouvement
aceji	le qui
nu ji	quelque
te	toute nuit dormir
ci cuɖuɖu	tranquille
xwe	tranquille
jo	restituer
jo nu mε	restituer
ze jo nu mɛ	restituer
buwuntu	restreindre
ja ji	resumer
lε	resurrection des hommes
klistu	resurrection du christ
fun se	retailler une meule
fun se	retailler une pierre a moudre
gan	etre
hwenu	etre
ɖe kpo	retenir
ɖo kεn ji	retenir
hεn	retenir
hεn ɖo te	retenir
hεn mε ɖo te	retenir
hεn nu do tamε	retenir
hεn nu tamε	retenir
kεn	retenir
ci mε ji	retenir quelquun
avi nu mεɖe	retenir ses larmes
ɖo te	retenir
fan nu	retenir a quelque
sin	leau quon fait bouillir
gba dεnɖεn	foule
jε mε ji	retomber quelquun
xwe te	retomber ses pieds
yi	retourner
yi gudo	retourner arriere
fli	retourner le recipient faire sortir pate
huzu nu	retourner une
kpan	retourner
gudo	retourner arriere
ɖe	retrancher
ɖe sin	retrancher
gbo	retrancher une partie quelque
sobwe	retreci
sobwe	etre retreci
wun	retrecir
sε do aga	retrousser
do mε	retrousser le nez signe moquerie
ɖo ayi te	retrouver froid
xlohun	retrouver seul
kple ɖo	etre reuni
yi kple ji	a une reunion
axijijε	reunion des au marche
nuxixo	reunion ou lon joue du
nuxuxo	reunion ou lon joue du
kpikple	reunion
kple	reunion
kplekple	reunion
mε kplekple	reunion
kple	reunir
sε kple	reunir
wa kple	reunir
kple	reunir traiter quelque
wu	etre reussi
kpa mε	reussi du
cε	reussir
kpa mε	reussir
kpo	pas reussir
gba mε	reussir a avoir
gba mε	reussir a mettre quelquun
din	reussir a concours
tεn	reussir dans quon entrepris
din	reussir
ku	faire reve
aɖi	reve premonitoire
aɖi	reve qui sest realise
gan	reveil
fin	letat ou lon trouve le au reveil
do mε wu	reveiller quelquun bonne heure
do vε nu mε	reveiller quelquun plein sommeil
winnya	reveiller
hawun	reveiller sursaut
nyi	reveiller sursaut
nyi	reveiller sursaut
ɖe nu xlε mε	reveler
ɖe	reveler
gba nu	pas reveler une affaire au jour
nu nyanya do mε wu	reveler les defauts
gunnuko	sorte tres qui devient subitement tres
sa	revendre
kpa tε	revendre au detail
fli sa	revendre au meme prix quon achete
wa	revenir
de	revenir a
ba mε kpo	revenir bredouille
sin	revenir
jε ali ji	revenir le chemin
tεkpikpa	revente au detail avec benefice exagere
sin	etre revenu
ku	rever
do do nu mε	faire des reverences devant quelquun baisant terre
do do	faire une reverence tete
alɔgudo	le
e su hweɖenu	au revoir
do yi bo wa nu mε	au revoir a quelquun
ku	etre egoisme revoltant
amaxuxo	revolte
gu	revolter
jε hete	revolter
do mε ji	revolter contre quelquun
gu do mε ji	revolter contre quelquun
huzuhuzu	revolution au benin
akpomεtu	revolver
awukplεmεtu	revolver
awumεtu	revolver
sunmεwema	mensuelle
fle nukun	avoir les yeux revulses
xuɖuxuɖwi	rhumatisme osseux
kpεn	rhume poitrine
ko	ricaner
ɖo	etre riche
kple dɔkun	des richesses
dε	etre ride
kanxisi	fibre bambou
fo	ridiculiser quelquun
nu ɖokpo a	rien
nu ti a	rien
nuɖe a	rien
nuɖewuɖa	rien
xisa	rincer vaisselle
hu mε	rincer
awajεdingan	ripaille
ko nu	rire
nukuko	rire
nukonukwe	celui qui le temps
hahaha	facon rire
to	faire rire
nukuko	le fait rire
kε awe	rire a et a travers des motifs futiles
ko nu hahaha	rire aux eclats
ko nu yavi	rire aux larmes
wla mε ko	rire beaucoup quelquun
ko nu xixixi	rire facon etouffee
ko nu xexe	rire facon sarcastique
ko nu xexexe	rire facon sarcastique
ko nu	rire quelque
ko mε	rire quelquun
ɖɔkwe	risee
ta wa	courir le
taa	courir le
yɛsu	des ceremonies funebres
jeɖiɖa	du
yɛsu	le culte des esprits
asuxixa	une femme ladultere ete decouvert
yɛsu	que lon accomplir vivre paix
li za xa mɛ	rivaliser
tɔzan	partie eloignee
tɔwunu	qui habite les villages lacustres
tɔfinnu	du leau ou lacustre
hlan	riviere
dun sin	riviere
ava	sorte riviere
do	robuste
xu	etre robuste
do nu	roder
cε	rogner
kpa	rogner
ɖu	rogner discretement nourriture que lon partager
sεn hwεn nu mε	rogner le du voisin qui laboure avec soi
gawu	du temps des rois dabomey
gezo	huitieme dabomey
saxe	le dabomey
agblagoji	le
dada	le glele
akaba	nom dabomey
adandozan	nom qui regna a abomey
agaja	dabomey a
dogbagli	dalada
dogbagligεnu	dalada
atinsu	des arbres
fεn	rompre
gba	rompre
tlεn	rompre
kija	rompre dechirant
tun	rompre le jeune
ja	rompre nimporte
kpɔfεn	sorte ronces les epines sont tres longues
klaxla	qui fait le
tobwe	et diametre
gblobotwe	et tres
xwalunlun	ronflement
lun xwa	ronfler
ɖu	ronger
nyi	ronger
acu	des champs
acu glεzin	des champs
glεnzin	des champs qui que nuit
mimε	roti
sisɔ	le fait rotir
hiza	rotir dans recipient avec lhuile et
gba va	faire
nyi akpa	faire
tε	faire
avɔkangbεkεkε	rouet traditionnel
vivo nyaa	eclatant
vɔvɔ nyεε	fonce
kponyinyi	rougeole
dohunnu	avoir rougeole
hu azwi	avoir rougeole
jε azwi	avoir rougeole
nyi kpo	avoir rougeole
jε hwε	rouiller
jε ko	rouiller
hwεjijε	le fait quun fer
kla	rouler
do	faire rouler vehicule
bli bu	rouler
fli zan	rouler une natte
bli gba	rouler terre
kutomε	le royaume des ombres
do	avec fureur
do	brutalement
wla	des marchandises
wla	nourriture
do gbe	rugir
aglin	ruines maison
hwin	quelquun
xwe	totalement une maison
nutuntun	du jeune
mɛ zinzin	ruse
mεbibi	ruse
mεsisε	ruse
ca	etre ruse
de	etre ruse
kla	etre ruse
sε	etre ruse
zin	etre ruse
gεdε xa mε	ruser avec quelquun
se gan	avoir le sens du rythme
gbla	rythme propre au vaudoun xebyoso
akatawunto	rythme
kpaca	rythme funebre
adi	variete rythme
sanmya	couleur roseemauve
nyεkεn	mer
vεsisa	qui est a terre
yɔsa	qui recouvre le tombeau
nyεkεntεnmε	sabliere
hwi	sabre et pointu
adla dεnkpe	sabre guerre
akpola	sabre dexecution
glo	le a glo
vatε	devin
kpεtεvi	tissu que les femmes
glo	a
aglo	decolier
caki	chanvre
aglo	general
tεkpo	peau dantilope
avo	raphia
kεnvi	fait avec des joncs
gbayikun ɖokpo	kg mais
gba	saccager
gidigidi	saccager
kpɔli	contenant principalement le
azɔkpla	le tabac et dautres accessoires
akpo	etoffe
saklamεtu	sacrement
yɛsinsɛn	sacrement
wuntungbɛna	sacrement lordre
yɛhweni le	sacrement lordre
kε	faire
su kuli	faire qui a ecarter
adlaɖenu	au fa
adla	offert au fa foret
adlaɖiɖe	ecarter malheur initie au
naxixε	sacrifices ou offrandes aux na
tanu	sorte le bonheur soi
nu do sa na nu	sacrifier quelque a
suɖuɖu	sacrilege
ɖu su	commettre sacrilege
ɖu su nu mawu	commettre sacrilege
ɖu su nu vodun	commettre sacrilege contre vaudoun
gba hun	commettre sacrilege contre vaudoun
hungbigba	sacrilege a vodunsi
ɖo mεxo ayi	etre
doto doto doto	femme diplomee
mεxoyi	sagesse
mεxoyiɖiɖo	sagesse
nunywε	sagesse
ɖi hun	saigner
do hun	saigner
so winnya	saigner du nez
nyε hun	saigner lanus
yɛhwe	paul
yɛhwenyinyi	saintete
hεn	saisir
sa	saisir
xo	saisir
sisa	saisir
gbla to	pas saisir
ayi wu	saisir sy
ayi ɖo e wu	saisir sy
wli ɖayi	saisir dans
wli ɖayi	saisir coeur
fan	saisir solidement
fan asu mε wu	saisir solidement
fan asu mε wu	saisir violemment quelquun lui arracher quil possede
akpakpa	saisissement
xweji hwenu	au temps grande saison des pluies
xweji	au temps grande saison des pluies
sinmε	au temps grande saison des pluies
ji hwenu	au temps grande saison des pluies
akumε	dans saison seche
aluun	dans saison seche
aluunmε	epoque grande saison seche
aluunsun	epoque grande saison seche
fomε	saison seche
mε	saison des pluies
ayi vodun	sakpata
sagbata	sakpata
yovoma	salade
sunmεkwε	salaire mensuel
sunzanfifokwe	salaire mensuel
sunzanfufokwε	salaire mensuel
sunzankwε	salaire mensuel
gbo adun	etre
kuji	etre
kwiji	etre
do jε mε	saler
do jε lan	saler viande
afεn	salete
afεnnu	salete
ɖixo	salete
fεn	salete
nukwiji	salete
wa afεnnu	faire une salete
jεgba	saliere
jεgban	saliere
jεgo	saliere
jεka	saliere
agbanutin	saliere toiture
jεgbaji	a
va nuɖe do mε wu	salir
xo	salir materiellement et moralement
hεn nuɖe kwiji	salir quelque
va baba do mε wu	salir quelquun
blewun	salir
ɖa	salir au quelque
fan adun	salir avec boue
xo adun	salir avec boue
fan	salir avec terre
fan mi	salir avec des excrements
va baba do mε wu	salir boue
xo baba	salir boue
atan	salive
dε	salive
atan fin fin	salive et intactes
agbasa	a
nuɖuxɔmε	a
akabaxɔsa	dattente au palais du
akpablaxɔmε	pansement
agbasa	repos
fagbasa	ou lon consulte le fa
tokplegbasa	publique
ajalalasa	variete
ajalasa	variete
ajalala	avec nombreuses portes
ajlala	avec nombreuses portes
do gbe	saluer
nu do mε	saluer quelquun
do gbe sun	saluer nouvelle
dogbe mε	saluer quelquun
do gbe mε nu mε	saluer quelquun au nom quelquun
mi nu mε	saluer quelquun
gbedido	salut
gbedomε	salut
gbedudo	salut
gingan	salut
hwinhwlεn	salut
hwlεngan	salut
hwlεnhwlεn	salut
doo	salut que lon adresse aux personnes qui reviennent
ayihun gidigidi	jeu
akɔnyinyi	jeu cartes avec enjeu
xwenumɛ	une des formes du jeu daji
sabaɖu	samedi
sabaɖuzan	samedi
satide	samedi
satidegbe	samedi
savodo	samedi
savodun	samedi
savodungbe	samedi
sibigbe	samedi
mε huzu yεhwe	quelquun
hunnuwatεn	sanctuaire
malεfɔkpa	sandale
salubata	sandale
hun	organe du et principe
hunɖiɖa	cuit prepare comme mets
hunlanfan	melange avec leau
gbegluza	espece sanglier
jiji	sangloter
afɔmasε	deplacer
afɔmasεmasε	deplacer
kyεkyε	soin
vazavaza	soin
gblowunkan	sous
gblowunkan	entendu
ɖo yiya ji	tarder
malinmalin	tarder
mεhɔnwun	vergogne
wuɖiɖi	etre defaut
jo kan	etre
da	etre
tli ji	etre peur
ayi jε do	etre souci
sa lele	etre soutien
sa xwexwe	etre soutien
hu winnya gbo	etre vergogne
kɔmalε	arriere
kplululu	arret
te	arret
temanɔmanɔ	arret
goo	arret
cεxwlε	assaisonnement
faa	aucun probleme
mawayε	aucune tromper
ɖo gbawunjo mε	avoir a rendre compte
kleje	avoir rien
masεtεn	bouger
hoho	cesse
hohoho	cesse
magbokɔ	cesse
hehehe	cesse
mamama	cheveux
fεε	contrainte
cuɖuɖu	ferir
woyaa	crainte
bluju	decorticage les noix palme
blɔ	defaut corporel
blɔmaɖowu	defaut
blɔmaɖowu	defaut spirituel
blu ɖa	dessus dessous
jεjεjε	faire
zaa	faute
xlowun	frotter a droite a
masatεn	grande
cεkii	histoire
fεε	inquietude
jamijo	maitrise
numaɖu	et boire
sinmanu	et boire
ɖoɖo	melange
nyε mεvo	moi
bluju	mouture
cayaa	ordre
makεnu	parler
fataa	le
fataa	lentree
cuɖuɖu	bouger
cuɖuɖu	parler
mamama	poils
fεε	probleme
mεhɔnwun	pudeur
kɔmalε	reculer
malεkɔ	reculer
malintamε	reflechir
makanɖekpo	reproche
hunnyahunnya	retenue
lεε	rien
nutimawa	rien faire
bεwunju	bonne sante
ɖo ɖagbe	etre bonne sante
wu	etre bonne sante
ɖagbe	etre bonne sante
ɖagbe	etre bonne sante
nu mε	etre bonne sante
nuxwixwa	sarclage
gle	quand terre est
ahwe	fraiche
ahwε mu	fraiche
gannumεhwevi	sardines boite
do	satisfaire
jε mε nu mε	satisfaire quelquun
kpe nu mε	satisfaire quelquun
ahaan	exprime satisfaite
xo wunta	pas etre satisfait
fun kpεtε	faire avec du et farine mais
fun hun	faire avec du et farine mais
nusunnu fin	veille rechauffee
gusi nusunnu	au gusi
nusunnu	brulee
ma nusunnu	legumes
nεnusin	nεnu
hwevi nusunnu	poisson
lan nusunnu	viande
wan	faite avec des haricots grilles et moulus
dεnu	filante
nusunnu	gluante
vatakpa	legere beaucoup condiments
nusunnu	que les europeens appellent souvent caloulou
kpaɖa	quelconque defaut certains condiments
jεmεsin	legumes
hlohlo	variete jumeaux defunts
agbo	faire le
nyi agbo	faire le perilleux
nyi ajagan	faire le perilleux
ajagan	perilleux
kan	sauter a corde
ɖi wun	sauter aux yeux
ɖi vo	sauter branche branche
ɖe vo	sauter branche branche
do asa	sauter dessus quelque
yi ji	sauter quelque
jlεgbo	sautiller
gbemεnu	sauvage
gan	etre sauve
gingan	le fait detre sauve
ɖeɖε	sauver
gan	sauver
ɖe hwεn mε	sauver quelquun
mε	sauver quelquun
yi	sauver
kpa	sauver
fanji	savane
se ama	etre
tuwun nu	etre
nunywε	savoir
nywε	savoir
nywεvi	celui qui sait
ku gan	pas savoir danser
nyla we ɖu	pas savoir danser
nylan we ɖu	pas savoir danser
dan do nu nuɖe	rien savoir quelque
nywε	savoir a lavance
se gan	savoir danser
we ɖu	savoir danser
hεn nu xomε	savoir garder
ji	savoir garder
tuwun do mε	savoir coeur
hεn nu xomε	savoir tenir langue
ji	savoir tenir langue
aɖikɔtɔ	savon
kɔtɔ	savon couleur grise
do aɖi	savonner le
sa aɖi do	savonner le
lε aɖi	savonner
aɖi	savonnette
yovoɖi	savonnette dimportation
vivi	etre savoureux
zege miblimibli	scarabee coprophage
zege	scarabee general
gbo hwε	faire des scarifications
ja atin	faire des scarifications
ja atin	faire des scarifications simmuniser contre quelque
gbo kisi	faire une
atinjija	dimmunisation traditionnelle
sakpatahwε	scarifications propres aux sakpatasi
gesi	sceau
tlε	sceller
sa	scie
kansa	scie a chantourner
kansaa	scie a chantourner
kansin	scie a chantourner
zε atin	scier
nyεnyεnyε	scintiller
kεn nyεnyεnyε	scintiller
ahɔnmεlala	scolopendre
hɔnmεlala	scolopendre
awolomi	scories
hɔnkekele	espece
kekle	espece
hɔnklekle	espece
agasa	tres
tlitli	scruter
gbeje	scruter attentivement quelque
kpa awinya	sculpter
kluba	seau
dotɔgannu	seau employe puiser
tɔka	seau employe puiser
akumε	au temps
mε	secher
mimε	mettre a secher
xya	faire secher
xu	secher au
xu zo	secher au
xiya lan	secher viande
linsinmε	secondaire
gbεɖε	secouer
hunhun	secouer
alɔmimi	secouer
mimi	secouer
jo linfin	secouer ligname ou du piles ramener a les morceaux quil faudra a nouveau
xuxu gbehan	secouer des touffes dherbes faire tomber terre
mi	secouer apres avoir touche quelque chaud
mi	secouer apres avoir touche quelque
xo	secouer pate quelle adopte du recipient
xuxu afuntuntun	secouer poussiere
xuxu	secouer tete
do mε	secourir
alɔdomε	secours
alɔgigo	secours
alɔgugo	secours
caxoxooo ɖie	au secours au voleur
kpanu	affaire secrete
donu	concernant les talismans et pharmacopee
hun xo	du vaudoun
hunxo	du vaudoun
hwlahwla	secretement
hwlan	secreter liquide
sɔnu	secteur du marche reserve a telle ou telle denree
lansɔji	secteur reserve a viande
lansɔnu	secteur reserve a viande
nakisɔnu	secteur reserve au bois chauffage
avosɔji	secteur reserve aux tissus
mε	seduire
gble	seduire
hεn mε gble	seduire
gble mε	seduire quelquun
lu mε	seduire quelquun
mε	etre seduisant
nεnε	sein
hwlan	avoir des seins naissants
gogoɖogo	seins formes et
ci	sejourner
jε	sel
jɛ xaya	du sel reduit poudre
jεkεn	sel
cyancyan	selectionne
ada gbla mε	avoir besoin daller a selle
nyε hun	avoir des selles sanguinolentes
zinkpo	selle velo
vodungbe gblamε	semaine
ɖi	etre a
ɖɔhun	a
jε nyi	avoir nom
ci ɖi	sembler
ɖi	sembler
afɔkpakpa	semelle
nukun	general
do jinukun	semer
do nukun	semer
do aziin	semer larachide
do avaja nu mε	semer du desordre
fun	semer du desordre
funfun nukun	semer du a volee
do hwinyahwinya mε	semer zizanie
hεn dan	semer lagitation
funfun nukun	semer le a volee
do hwinyahwinya mε	semer le
agunkpamε	semeur discorde semeur troubles
yɛhwenɔ gleta	seminaire
hu nukwin	faire des
va nukwin	faire des
va nu	faire
tinmε	sens
blu ɖa	etre sens dessus dessous
nyii wiiin	exprime une bienetre
yaa	qui fait eprouver une douleur et fugace
hun	du akaba
aliswεεn	sentier
yɛhwin	sentier que tracent les animaux dans brousse
nukanmεli	sentier brousse
ɖe wan	sentir
lun wan	sentir
se wan	sentir
wuyamɛ	le fait sentir leger
hwinhwεn	qui
yi	sentir honore
wan	sentir
jε mε	seoir a quelquun
klan	separation
klanklan	separation
xɔgbigbo	separation
xɔgbugbo	separation
ɖo vo	etre separe
vokan vokan	separement
ɖa	separer
ɖe ɖo vo	separer
gbo	separer
kan mε ɖo vo	separer
klan	separer
kija	separer brutalement
ɖe	separer morceaux
ɖe	separer quartiers
ɖa hun nu mε	separer deux combattants
ɖa mε	separer deux personnes
cyan dekin	separer les amandes palme leur brisee
vuvomumɔ	serenite
fannafanna	serieux
xwle aɖi	faire
xwle mawu nyi	faire
tɔdan	aquatique
danmifun	bananier
xlibo	cracheur
domεdan	tres
domεdan	des revenants
aɖiɖan	tres venimeux
lεnklεnsεn	tres venimeux
amanɔnu jakpata	trigonocephale
jakpata	trigonocephale
dangbe	vaudoun
lyεnklεnsεn	qui grimpe aux arbres
danmifun	tirant le jaune
xasaxasa	enroule lui
xasaxasa	meme
fεn	serre
tεnwun	serre
kpiti	etre serre
janjanjan	tres serre
kpitikpiti	tres serre
sin kan do	serrer
xa	serrer
sε do mεɖe wu	serrer
bla	serrer ceinture
tablanu	serretete
sin	serrer autour des
sin do alin	serrer autour des
do mε	serrer a felicitations
na mε	serrer quelquun
hεn flεεn	serrer le frein
xa mɛ	serrer quelquun
tabla tabladukwi	serretete
go	qui serre
sεli	serrure porte
devi	servante
wa nu mɛ	etre au quelquun
nu mɛ	etre au quelquun
sεn	servir
wlo nu ɖu	servir abusivement des biens necessaires a autrui
do wa na	servir a
wa na	servir a
se gbe nu mε	servir dinterprete a
sεn	servir le
devi sunnu	serviteur
yi vi	enfant comme serviteur
alihεnnu	seuil
hwε	seuil
kpekan	seuil
kpokan	seuil
hɔnlihεnnu	au seuil
hɔnlinu	au seuil
ɖoɖo	seul
bavu	seul
gbligbε	seul
hawun	seul
hawunhawun	seul
hwεnwun	seul
kpete	seul
mawun	seul
mlawun	seul
mlεwun	seul
towun	seul
vawun	seul
gbuwun	seul
lolwe	etre seul
ɖokpo	seul
ɖokpogee	seul
gee	seul
nu ɖokpogee	une seule
ɖokpo	une seule fois
ɖokpogee	une seule fois
xlohun	seule
jan	seulement
jεn	seulement
kpowun	seulement
kεɖε	seulement
atan	seve du palmier
lokocε	seve du roko
hun zo	etre severe
syεn	etre severe
hunnylanyla	severite
jijɔsyεnsyεn	severite
ɖe nu vi	sevrer enfant
nɔ	dans le sexe mere
nɔwe	dans le sexe mere
anaganta	sexe femme
ɖo	sexe masculin
mama	sexe
vatε	sorte
vatε	sexe rudimentaire
blo vayuu	jeune garcon qui des rapports sexuels avec une jeune fille et versa
yi sunnu	avoir des rapports sexuels avec homme
ba sin nyi ayi	avoir des rapports sexuels avec homme
yi	avoir des rapports sexuels avec une femme
ba nu ɖu	avoir des rapports sexuels avec une femme
kpan	avoir des rapports sexuels avec une femme
wa	avoir des relations sexuelles
wa yo	avoir des relations sexuelles
ba mε	avoir des relations sexuelles avec une femme mariee
ba	avoir des relations sexuelles avec une femme mariee
gba nu mε	avoir sexuel avec une jeune fille vierge
jε xa mε	avoir sexuel avec quelquun
kpe xa mε	avoir sexuel avec quelquun
wa	faire lacte sexuel
ci ɖɔhun	comme
vε	seulement
xwe kanweke	siecle
azinkpo kijεkijε	siege branlant
ayi	siege du et pensee
jan	siege fait avec des branches palmier raphia
ee	sien
kun kpete	siffler
kwinkwin	siffler
kun kwin	siffler avec
kwin	siffler avec
kun fle	siffler avec metal
kun sun nu vi	siffler ceremonie sunkunkun
kun sun	siffler ceremonie sunkunkun
nujijlε	signe
nujlεjlε	signe
mi nu mε	faire signe a quelquun
gbo wunda nu mɛ	faire signe a quelquun soulevant les sourcils
mi nu	faire signe a
ze nu mε	faire signe a
mi nukun	faire signe des yeux
wun	faire signe des yeux a quelquun
mi nukun nu mε	faire signe des yeux a quelquun
mi wun nu mε	faire signe des yeux a quelquun
ɖo wuntun	faire signe
gbo wunda	faire signe et abaissant les sourcils oui
wuntun akluzu	le signe croix
nusinnu	signe mauvais augure
dutitε	signe du fa
du	signe du fa
fadu	signe du fa
gbadu	signe du fa le possesseur est tres craint
loso	signe du genie
duvi	signe
duvi	enfant dans du fa
dutitε	signe
dutitε	mere dans du fa
do wema mε	papier
tε wema mε	papier
do wema	une lettre
makεnu	silencieusement
fε hwεn	faire deuxieme partie
kan hwεn	faire premiere partie du
fε hwεn	faire le deuxieme cote
kan hwεn	faire le cote
fεnvi	silure
cεnkεn	silure
fεn	silure avec trois nageoires renforcees piquants
yaya	etre
kεɖε	simplement
kεɖεε	simplement
kpowun	simplement
nugbo	etre sincere
ɖo te	etre sincere
ɖo	etre sincere
abawe	especes
ha gbonɔ	male
tɔklaan	couleur avec le
aklaan	jaune
klaan	jaune
zinblawewe	a
wu	sinon
ahanvivi	sirop
kpεngla	sixieme dabomey
ku xomε	pas etre
gεlεdε	societe secrete
ganbaɖa	societe secrete sorciers
asi asi	bellesoeur
dada	grande soeur
dada	soeur ainee
ahangbe	soeur
sεda	soie naturelle ou artificielle
sinnugbla	soif
xo bo	soif
xu mε	avoir soif
sin gbla mε	avoir soif
sinnugbla sin mε	avoir soif
kpe nukun wu	soigner
do ama mε	soigner maladie quelquun
akpa	soigner une plaie
xo akpa zo	soigner une plaie
xo akpa zo	soigner une plaie avec leau froide
zin wu	etre soigneux
bo nu	soin
nukunkpedomεwu	soin
bowliwli	le fait soin
gbada	soir
gbadanu	soir
hweyixɔ	soir
zankuku	soir
gbadanu	soiree
gbadanu	dans soiree
kpan kpan	soit que soit que
kpan kpan	soit soit
kanɖe	soixante
kanɖe gban	soixante
kanɖe gban	dix
hwezivɔ glagla	brulant
hweze	comme lumiere
nyanya	torride
janjan	solide
syεnsyεn	solide
tεkowo	solide
wutu	solide
dε kan	etre solide
syεn	etre solide
syεn kan	etre solide
syεn da	etre solide
nagun	solide et vigoureux
jangbanjangban	solidement
syεnsyεn	solidement
tanwuntanwun	solidement
xo to	pas etre solidement fixe
kpantyangan	solidement plante debout maniere obstinee
kpanwunkpanwun	tres solidement
caɖaa	solitairement
kadaa	solitairement
nukunkpedomεwu	sollicitude
nukunkpenuwu	sollicitude
wlɛnwinɖiɖe	le fait chercher une
fli xwe	sombrer
sin mε	avoir sommeil
ɖo mε	etre plein sommeil
wunzεn	navoir pas sommeil
sa	sommeiller
ɖo ji	etre au sommet
azan	le sommet arbre
zan	le sommet arbre
amlɔtinkεn	somnifere
sin mε	somnoler
nyi bɔlu	somnoler
sa	somnoler
asi tɔn asu	beaupere
kpεngbe	flute
vi gudo	enfant
kpεngbe	du
vi su	gendre
ku	faire songe
ku	songer
lin	songer
gannxoxixo	sonner
kun lanzo	sonner
xo gan	sonner
bo	sonner une
xo gan	actionner sonnette velo
caɖagan	sonnette que lon faire quen retentir devant cortege femme du dabomey ecarter tous les hommes
lele	voix sonore
lelele	voix sonore
minɔna	nom generique et religieux sorcellerie
ɖo aze	etre sorcier
ɖo aze ka	etre sorcier
ɖo	etre sorcier
ɖu aze	etre sorcier
tεnmε tεnmε	differentes sortes
nahun	quelle sorte
tεnmε tεnmε	toute sorte
hamεhamε	toutes sortes
nukunmε nukunmε	toutes sortes
blo ni su ɖaxo	faire sorte que
sun	faire faire premiere a enfant et mere
sun nu vi	faire premiere
viflefle	loeuf
aze	sortilege
boɖonumε	faire des sortileges contre quelquun
bo nyanya	faire des sortileges contre quelquun
sa bo gbe	faire sortilege faveur quelquun
nya	faire sortir
nya mε	faire sortir
nya sε do	faire sortir
tun	faire sortir
ɖe sin	faire sortir
xwi sin	faire sortir leau
ɖe hun	faire sortir les nouvelles recrues du couvent vaudoun
ɖe nu nyi te	faire sortir quelque
fle	faire sortir quelque enveloppe
tun mε	faire sortir quelquun
ɖe su	faire sortir quelquun du couvent
jε te	sortir
fle azin	sortir loeuf
fle vi	sortir loeuf
flele	sortir terre
kpa	sortir cavite naturelle traversant paroi
kpodo kpo	sortir
kun	sortir bourgeon
mεɖimε	sosie
xlo	etre
yɛyi	etre
lu	etre
lu nu	etre
yɛyijijo	sottise
yɛyijujo	sottise
gba	faire des sottises avant lage
do kun	faire souche
tamεlinlin	souci
gba tamε nu	faire du souci a quelquun
adi ci mε	faire du souci
adi hu mε	faire du souci
hu mε	faire du souci
ɖo hun mε	faire du souci
keya	soucier
kiya	soucier
wu	etre soucieux proprete
vawun	soudainement
ca	souder
ca gan	souder
kpe	souder
tlε	souder
nutitlε	soudure
fun funfun	souffler
ɖe kpa mε	souffler a loreille
fun zo	souffler le
futukeɖe	soufflet traditionnel que lon actionne verticalement chaque
gba tomε	souffleter
nyi zo nu mε	souffleter
xo	souffleter
nyi zo nu mɛ	souffleter quelquun
nuvivε	souffrance
wεn	exprimer souffrance
ci mε	souffrance
ɖu ya	souffrir
ji ya	souffrir
xo keve	souffrir
do ya nu mε	faire souffrir
ɖe do mε	faire souffrir
do ya nu mɛ	faire souffrir
wa nu xa mɛ	faire souffrir
yajiji	le fait souffrir
sinnugbla sin mε	souffrir soif
wuvε	souffrir moralement ou physiquement
ɖu ya	souffrir terriblement
ɖumu	soufre
ɖεxixo	souhait
jijlo	souhait
ceke ceke	a souhait
lo	particule a exprimer souhait
do vodun mε	souhaiter des malheurs a quelquun
xo nu vodun	souhaiter du a vaudoun
do vodun mε	souhaiter du
xo ɖε nyanya	souhaiter du
do xwe gbe nu mɛ	souhaiter fete a quelquun
xo ɖε nu mε	souhaiter quelque a
hεn gble	souiller
va nu	souiller quelque
baba	souiller boue
fan baba	souiller boue quelquun
nu mɛ wu	souiller une fille
ɖakpεɖε	souillure
nukwiji	souillure
do fifa	soulager
yi nukan mε	soulager
na mε	soulager quelquun
sinmεnu	soulard
do ji	soulever
yi ji	soulever
ɖonya	soulever
xo zin	soulever
dεεn	soulever
ze	soulever objet
gloginu	souliers ferres des soldats
jo nu mε	soumettre a quelquun
nu nu mε	soumettre a quelquun
nyi akan	soumettre a
nyi kan	soumettre a lepreuve corde
kpe aɖi	soumettre quelquun a lepreuve du
kpe aɖi nu mε	soumettre quelquun au depreuve
ɖo te nu mε ɖe	soumettre une affaire a quelquun
nuvεdomε	soupcon
vε nu do mε	soupconner quelquun quelque
vε ajo do mε	soupconner quelquun
dan	soupeser
xo	soupeser
gbigbɔjε	soupir
tɔtaligbe	riviere ou fleuve
nukuntafun	sourcil
ku to	etre sourd
ajakawlija	souriciere
ko nu	sourire
sɔsumaseɖe	sorte souris a touffue dangereuse
ajaka heto	souris chapardeuse
heto	souris grise au ventre
awlinmεdan	sournois
mε blublu	sournois
asa	sous
nu	sous beaucoup rapports
mε asi	sous dependance quelquun
tavo gwlε	sous
atinsa	sous larbre
totinsa	sous larbre a palabre
lokosa	sous le roco
ɖo pilatu si	sous
ɖo pilatu si	pilate
hwe sin mε	soustraire
gan	soutenir
de wu nu mε	soutenir quelquun
yi gbe	soutenir une
alɔdomεtɔ	soutien
jε gblolo mε	navoir aucun soutien
anɔblanu anɔbεnu anɔwlinu anɔwliwu	soutiengorge
bu wan	quelque ou quelquun
bu wun	quelque ou quelquun
bu	quelquun
bu nyi	quelquun
flin mε	quelquun
mεflinflin	quelquun
gege	souvent
hwεhwε	souvent
xagan	special
su	spontane
wezunkinkan	le
xu glo xugblagbla	squelette
glaoglao	squelette
govikacwe	squelette
kacakaca	squelette
bobo	bois ou terre
vimaji	sterilite
lu	etre stupefait
mεsegan	stylee
mεɖomεsi	subalterne
sun sin	subir mauvaise
sεn gan	subir lemprisonnement
nyi kan	subir lepreuve corde
ɖu aɖi	subir lepreuve du
ɖiɖa zekpete	subir les consequences acte dangereux
kpowun	subitement
tlolo	subitement
vawun	subitement
ni	subjonctif exprimant souhait ordre
do mε	submerger
kpo ɖo	subsister
gudo	succeder
mε	succeder a quelquun
adlajidlaji	successivement
cεwun	succinctement
jε mε	succomber a
wli	etre
do sukle mε	sucrer
ɖiɖi	sucrerie du dorge
yovojɛgban	sucrier
tofɔligbe	le pays
dεnjijε	sueur
kpe	suffire
kaflaka	suffisamment
kpikpe	suffisamment
nu mε	avoir a suffisance
kpe	etre suffisant
su	etre suffisant
kpe	suffoque
hu mεɖe	suicider
gudo	a
jε gudo	suivre
kpla	suivre
do	suivre
xwe do mɛ	suivre
lanxwiɖaxwiɖa	suivre le gibier a
do mε	suivre piste quelquun
xwiɖa	suivre le gibier avec precaution
jε gan	suivre le rythme
do	suivre les traces
jε mε gudo	suivre les traces quelquun
xwiɖa	suivre ou quelquun
jε tunnu mεɖe	suivre quelquun
ali	suivre chemin
ɖo tamε	au sujet
ɖo wu	au sujet
ɖo wutu	au sujet
gblamε	au sujet
kukumakwi	summum
yɛmɛnuwiwa	supercherie
yɛnuwiwa	supercherie
kpo ɖe ji	superflu
mεɖomε	superieur
mεhuganmε	superieur
haga	a niveau superieur
hu gan mε	etre superieur a quelquun
ganhumε	superiorite
cucu	idee superlatif
nyagoo	le superlatif avec lactif vova
cwicwi	meme sens que cucu dans le langage enfantin
jawun	superlatif a dur
foo	superlatif a wewe
tete	superlatif a wewe
pepe	superlatif au verbe we
pepepe	superlatif au verbe we
twεtwε	superlatif fa
tyεtyε	superlatif fa
dudu	superlatif
cεcε	superlatif
cece	superlatif mε
na	supplement
kεn	supplement
xuna	supplement
nyi mε	faire supplications
hεn nu mε	quelquun
ci kpε nu mε	quelquun avec insistance
jε nu mε	quelquun avec insistance
zanhwlahwla	supports du matelas ou natte
ɖo yozo	chaleur
dε ɖo jɔhɔn	le froid
ya agban	une
sin i	supprimer
su kun do	supprimer
xla	pas supprimer
gble mε	supprimer le
vi sin	suppurer
ɖo ji	etre
kpeta	marche
gbεmε fi	terre
ɖokpo	le
caa	le
tlolo	le
alita	le
alixo	le
lixo	le
ajɔlinu	le chemin du
ajɔlixo	le chemin du
ku zan ji	le
azata	le plafond
ge	le
kɔxo	le
kpeta	le seuil
we	le sexe pere
atɔwe	le sexe pere
tlolo	lheure
aceji	ses gardes
gomε	soi mais cache
lelele	tres eleve
kpannyawun	sur
la	sur
ɖe ji do wu	etre sur
tε ji	etre sur
cica	suranne
ca	etre suranne
sa	etre suranne
mε nu	surelever
ɖo sin nukunmε	etre a leau
xwe	surgir
kplakasε	qui surmonte lautre
kplεkεsε	qui surmonte lautre
aglavun wesu	surnom applique au
aglavun wesu	surnom
koliko	surnom hla lhyene dans les recits legendaires et les proverbes
gican	surnom tortue
kanlinɖujε	surnom lhomme
dɔkunnɔ	surnom sakpata
agbo	surnom des amazones du royaume dabomey
daaga	surnom donne a homme grande
fofo	surnom du frere
kinikini jawunta	surnom du
kinikini	surnom du glεlε
hii	surprenant
ji wu	etre surprenant
kpaca	etre surprenant
fyan	surprendre
gbo do	surprendre
hεn hun nu mε	surprendre
do mε ji	surprendre quelquun
gbo mε do	surprendre quelquun
hun nu mε	surprendre quelquun
hun xa mε	surprendre quelquun
do mε ji	surprendre quelquun delit
o	qui
si nu	sursauter
nyi	surveiller
zan	surveiller nuit
jε	survenir
wa	survenir
ɖo te	suspendre
do azan gle mε	suspendre
kpla	suspendre
do	suspendre au cou
sa nu do kan ɖo ji	suspendre quelque a une corde
nu do kan ɖo ji	suspendre quelque a une corde
jawunta	symbole et terreur
kinikini jawunta	symbole
mε	etre sympathie avec quelquun
ji	du jinukun
asi towe	mere
gboke	tabac
azɔkpla	blague a tabac
azɔfunfun	tabac poudre
azɔfunfungba	tabatiere
batakin	tabatiere
fu	nom du des principaux le fa
gbe	nom du des principaux le fa
kataklε	tripode seule piece
katakε	tripode seule piece
gun	peau
kan nu mε	faire travailler a tache
hwεn	tache
xo	tacher
va nuɖe do mε wu	tacher quelquun avec quelque
va de wu	tacher
wu	tacher
syεn xu	tacher
do go	tacher reussir dans une entreprise
kpan	etre taciturne
ja	taillader
ɖo ha ji	etre meme
hwe gli	etre
gbo	tailler
kpa ɖa	tailler
hunkpatɔ	celui qui les pirogues
kan aɖu	tailler les dents pointe
sla	tailler avec le
kan	tailler dans pate cuite
kpa awinya	tailler des pierres
kpa atan	tailler le coeur du palmier faire venir le vin palme
ɖa	tailler legerement les cheveux les bords
kpa	tailler superficiellement
atinkanmε	taillis
nabɔε abɔε	taire
xwɛ	taire
do wu nu mε	taire les agissements reprehensibles quelquun
kpan	taisant courageusement ses soucis
kpan	taisant courageusement ses peines
kpe agban nu mε	faire pouvoir garder enfant qui vient au monde apres le deces frere
botoyi	faiseur
zindobo	le utilise rendre
kpeku	nom
sanlin	sorte
kija	sorte qui a semer du entre deux ou plusieurs personnes
cakatu	sorte qui agit a
asanlin	et
asannyi	et
tila	enferme dans et contenant une magique
atinma	fait avec des feuilles darbres
bokun	liquide
awle	les acheteurs
awle	lestime des
nudonumε	empoisonner
nudonumε	obtenir quelque
gogbahun	sorte
gogbahun	vaudoun
kpanu hun	des assiettes
ku hun	des morts
ganganwun	entoure cordes
gota	les defunts
cεnkunmε gohun tɔhun	tamtam les defunts chez les maxi
hwεɖε	vaudoun
masε aca	groupe tamtam
jevivitin	tamarinier
tɔhun	leau
gangawun	des des yoruba
zokwete	des nɛsuxwe
kpezin	fait jarre entouree vannerie
dogba	dabomey
hun	appele couramment
kutituhun	variete
huntɔ	tambourineur
gixwinu	sorte filtrer farine dans leau
dugba	gari
linfin	tamiser farine
gba gali	tamiser le gari frais avant torrefaction
do gali abɔbɔ ji bo ɖu	tamiser le gari frais avant torrefaction
xwi gi	tamiser le gi dans leau
zin do ji	tamponner
ɖa anyu	le
tasi	tante maternelle
nagan	tante maternelle agee que mere
nafi	tante maternelle jeune que mere
daa	tante paternelle
novi	tante paternelle
zingidi	tapage
xo zin	faire du tapage
zin wema	a
zin do	contre
zin do ayi	du
hun	le
hwenu din	etre tard
sεxlo	targette
cigididɔ	tas saletes
cigididɔ	tas dordures
ɖiɖo	tas
sonu	tas
cyan kple	faire tas choses triees
klisi	faience ou porcelaine
klisivi	faience ou porcelaine
kpiwunkpiwun	tasse
zin ayikungban	le
ɖo wu	tater
do wu	tater
hεn	tater
xo	tater voir
avi	a tatons
avidladla	laction chercher a tatons dans le
gbo kisi	faire tatouage
hwε	tatouage
hwεgbigbo	tatouage
hwεgbugbo	tatouage
gbo hwε	tatouer
nyibu asu	taureau
nyibusu	taureau
kan akwε nu mε	quelquun
nu mɛ	quelquun
tεkigbo	teckeraie
tεkikan	teckeraie
do aho	teindre a lindigo
do yowunbo ɖa	teindre les cheveux
jε ka	avoir le teint clair
sin	teinte
aho	teinture dindigo
yowunbo	teinture noire les cheveux
ayi	tel quel
kpabaa	tel quel
kantitε	telegramme
kantε wema	telegramme
do mε	telegraphier
tε kan	telephoner
tε kan sε do mε	telephoner
ɖaɖa	tellement
gla	etre temeraire
glagla	temerite
ɖe kunnu	faire faux temoignage
ɖe kunnu	faire faux temoignage
ɖe kunnu	temoigner
ɖo xa mε	temoigner lamour
mɛ	temoigner beaucoup a quelquun
ɖe gbe nu mε	temoigner bonne foi quelquun
tomε	tempe
jɔhɔn syεnsyεn	tempete
dangbe xwε	des serpents
tεn	temps
tεn mε	temps
do hwenu	temps
tεn	avoir du temps
tan	avoir du temps
vivo	avoir du temps
vuvo	avoir du temps
xoxo hwenu	dans lancien temps
jixomε	dans le vieux temps
jixomε	dans les temps anciens
hwebinu	temps
le hwenu	temps
le hwenu	ci
hwenεnu lɔ	temps
hwenεnu lɔ	la
do gan mε	etre a temps
sin hwenu	le temps du
nu do hwenu	le temps des semailles
gbεmε ci kpitii	le temps est couvert
gbεmε a	le temps est couvert
gbεmε ci kpitii	le temps est
nukɔnmε	le temps futur
hwenu xoxo ɖayi	le temps jadis
xixo hwenu	le temps ou lon peut etre corrige
hwenu e mi ɖe	le temps present
afɔdlεn hwεnu	temps detente
xo hwenu	temps grossesse
zo hwenu	temps saison des pluies
gbogbo	temps eloigne
avεntu	temps liturgique
xuxo hwenu	temps ou lon peut etre frappe
syεn	etre
xwe nu	etre
akobε	tenailles
bɔkle	tendre
vεna	tendre
mɔɖuɖo	le fait tendre piege
mɔɖonume	le fait tendre piege a quelquun
tε	tendre
sin hun	tendre peau
da ga	tendre larc
tε to	tendre loreille
to	tendre loreille
nu to	tendre loreille quelque
nufεnufε	tendre pousse terminale branche
ɖo fεca	tendre piege
ɖo	tendre piege
hεn	tenir
ɖu su	pas tenir compte des habitudes quelquun
hihi wu	pas tenir
bu do	pas tenir promesse
nu	tenir compte daucun
nu	tenir compte daucune barriere
nu	tenir compte daucune loi
do wu	tenir a cote
ci te	tenir debout
te	tenir debout
xwe te	tenir debout
ba wi	tenir reserve
jε hun do nu ji	tenir a
hεn hun nu mε	tenir a coeur a quelquun
ɖo vo	tenir a lecart
ɖo ayi ji	tenir compte
gbo gbe nu mε	tenir compte personne
ze hεn	tenir dans
dafε	tenir des propos badins
xo	tenir des propos badins
yi kpa	tenir des propos confidentiels
nu ji	tenir
sin adan	tenir fortement
mε sin ɖo te	tenir a quelquun
do	tenir le suivant
gbe	tenir tel ou tel propos
gba mε	tenir tete a quelquun
nuɖe do mε wu	tenir objet tellement cher quon le ceder a autre
aa	tiens
aan	tiens
ca	tiens exprime douleur lindignation
caa	tiens exprime douleur lindignation
cayi	tiens exprime douleur lindignation
hun hu gan mε	avoir
ahwangoxo	tente militaire
tεn mε	quelquun
jε acɔ	sorti tenue
abεdan	tenue tres
ahwanawu	tenue militaire
zatin	terebinthe
xo	tergiverser
vi	etre a terme une femme enceinte
kasa kasa	termine
kasaa	termine
tutu	aile essaimage
agbotla	a grosse tete
gbakwεgbakwε	termitiere
je	etre terni
ku awi	ternir
hankan	cultive a precedente saison
jɔmεhunjayitεn	daviation
nukan	envahi des grandes herbes
gbehanmε	inculte envahi les herbes
kεntεnmε	rocailleux
nyεkεntεnmε	sablonneux
zin do ayi	terrasse
nyi do ayi	terrasser
zin dayi	terrasser
zin do ayi	terrasser
zin	terrasser
zin mε do ayi	terrasser quelquun
gbεmε	terre
do ayi	a terre
xwlakɔ	terre
xwlakɔ	popo
li	nom sacre terre
gle	terre cultivee
glelilε	terre cultivee
gbe jeke	terre desolee
didε	terre petrie
nyinya	terre petrie
mlimli	terre petrie et roulee boules
vεsisa	terre sablonneuse
vεyisa	terre sablonneuse
ayikungban vatankpannya	une terre completement boueuse et glissante
xɛsi ɖaxo	terreur
nylan do	etre
do xɛsi nu mɛ	quelquun
adanzun	tertre bravoure
mε towe lε	tes amis
doko towe	tes ancetres
mε towe lε	tes parents
goxwε	tesson bouteille
adogannu kpεtε	tesson et recourbe quon emploie caler le
sεn xoxo	lancien
akɔjijε yaɖeyaɖe	le nouveau
sεn yaɖe	le nouveau
yaɖe	le nouveau
nεkwin	testicule
akplɔkan	bourses avec les testicules
akplɔkankwin	bourses avec les testicules
akplεkan	bourses avec les testicules
katikati	tetanos
tamε	tete
hun ɖu	avoir tete troublee
ɖo tamε	avoir toute tete
aglɔkpo makpo tagbanu	cassetete
ɖo mε	etre dans tete quelquun
jε aglaja	faire tete
koɖokoɖo	tete
tasunsun	tete chauve
ɖekpata	tete du palmier
kakεtin	tete comme le kake
takpedo	tete tournee vers le
syεn	tetu
ci tamε	etre tetu
kpεn	etre tetu
ti tamε	etre tetu
tli to	etre tetu
xu tamε	etre tetu
sin	tiedir leau
mε towe lε	les tiens
we	tienne
aanyi	tiens
ke	tiens
kee	tiens
donu	le tiers
ɖo	le tiers
aziinkan	apres recolte
sεkan	chiendent
gbaɖe han	mais
kan	plantes sarmenteuses
hankan	tiges des cereales deja recoltees
xeɖulinfin	rampante qui produit des petits fruits rouges
xɛlinfin	rampante qui produit des petits fruits rouges
tilapia nilotica	tilapia
tεnblu	poste
kpan	etre timide
ku winya	etre timide
aɖɔwe	tique
gan	etre tire daffaire
nukunhunhun	le fait savoir daffaire utilisant beaucoup relations
nyi klohwan do mε	a fronde contre quelquun
nyi do	au objet
nyi do nu	au objet
lun sε	paille tas
ɖu le	des benefices
ɖe so do nu	des coups quelque
lun	du dedans
da	et manquer le
tun	langue
gbidi nu mε	les vers du nez
fε gbla	quelque et le manquer
xwi do nu ji	dessus
da ga	une fleche
lɔn	tisser
asansan	fait morceaux tissu couleurs et dessins differents
botoo	sorte tissu tres marche
sigi	tissu a petits carreaux
cigan	tissu cher
vedomε	tissu deuxieme qualite
nyinya	tissu lave
civi	tissu peu cher
cigan	tissus qualite superieure
kuwuntu	tissu
daagbo	donne aux eveques chez les catholiques
daa	donne aux rois
fun	tituber
fun sa	tituber
ajala	toile coton ecru
caki	toile plastique
canyinyi	intime femme
ca	intime que les femmes juste apres le
nugudo	toilettes
fun nukunmε	faire intime
gbo ja	faire deshabiller completement
wu	faire une rapide savon
yi nugudo	aux toilettes
xɔta	le
kpanu	tole
xɔgbagannu	tole employee une toiture
gbo	tomate
timati vivo	tomates tres mures
timati vuvo	tomates tres mures
nu gbε do mε	etre tombe dans misere
yɔdo	tombeau
zɛbε	tombeau ou lon creuse
akpasa	variete tombeau
flε	tomber
jε	tomber
jε ayi	tomber
hu dε	faire tomber
kpikpe	faire tomber
zin	faire tomber
zin	faire tomber
zin do ayi	faire tomber
lunlun	faire tomber des feuilles ou des fruits
zin mε do ayi	faire tomber quelquun
xo mɛ zin dayi	faire tomber quelquun terre
taɖuhunhun	le fait tomber dans
kεnxuxɔ	le fait tomber inimitie avec quelquun
jε ayi	tomber a terre
jayi	tomber a terre
jε	tomber daccord
jε xa mε	tomber daccord avec quelquun
jε	tomber dans misere
jε gblolo mε	tomber dans le vide
jε likpa mε	tomber dans lindigence
jε	tomber dans une etendue deau
jε hwε mε	tomber dans une faute
flε sin	tomber
ɖi jε	tomber soi meme des fruits murs
sa	tomber sommeil
flε	tomber arbre
nu	tomber defaillance
ɖu afɔku	tomber disgrace
jε kεn xa mε	tomber inimitie avec quelquun
kεn xa mε	tomber inimitie avec quelquun
sun ci te nu mε	tomber enceinte
kun	tomber a
kun tewun tewun	tomber a
xwe do	tomber contre terre
xwe su do	tomber contre terre
adan	tomber malade
jε	tomber malade
jε lanmε	tomber malade
lanmε wa nu mε	tomber malade
xo	tomber terre et etre sali
ɖe atan	tomber quelques gouttes pluie
lunlun	tomber successivement
jε ji	tomber
do	tomber tete
jε mε ji	tomber quelquun qui puisse daffaire
jε ji	tomber une porte fermee
anɔwe nɔgbo anɔwe we	grandpere paternel grandmere maternelle
kpa ɖa	tondre
kpa fun	tondre
ɖa	tondre les cheveux
kpa fun	tondre les poils bete
so nyi awan	avec
ji vodun	tonnerre
xεbyoso	tonnerre
dadeso	tonnerre et rapproche
la zogudo	faire
ku su	pouvoir une
sε sε	des doigts
zohwin	torche
fu	torche faite branche palmier fendue et utilisee seve du palmier
gban	tordre
gbandan	tordre
gbε	tordre
sin nuɖe mε	tordre du
slo kan	tordre une liane faire une corde
gbingban	tordu
klεjεε	tordu
lεgεdε	affaire tordue
gban	etre tordu
wlo	etre tordu
gbandan	etre tordu
klεcεε	tordu
gba hun	torpiller
nyanya	torride
wayawaya	a et a travers
nyla	avoir
ku	avoir
hu do mε	avoir envers quelquun
blu	faire du a
hu do mε	faire du a quelquun
ze nyi gbe	avoir le torticolis
akpata logozo	tortue
akpata logozo gican	tortue
se	espece tortue deau
xumε logozo	tortue mer
tɔklo	tortue deau
gbingban	tortueux
gεdεdε	tortueux
gεdεgεdε	tortueux
gεdεε	tortueux
gεdε	etre tortueux
ɖu wuwε	etre a
ɖu ya	etre torture
do ya nu mɛ	quelquun
kasa kasa	totalement
kasaa	totalement
vεεn	totalement
zin	etre totalement forme
hun	etre totalement ouvert
kεyεkεyε	totalement demuni
kpεncεnkpεncεn	totalement impregne liquide
ɖo sε gbe ji	totalement
kpikpe	totalite
kpete	totalite
mlεmlε	totalite
hun zε	etre touche
zε hun nu mε	etre touche
va de wu	a
si	avec du
ze do nu mε	avec a tete quelquun
ayi bo	terre puis poitrine
sa fεn	longle
fεn	longle
hunhun ayi	le coeur
ɖo nu wu	quelquun
xo zo mɛ wu	quelquun
ɖu ɖo lanmε nu mε	quelquun
si zo mε	rapidement quelquun avec du
acugwidi	touffe cheveux au sommet du crane
hiyεhiyε	touffu
hiyεε	touffu
tεgbε	toujours
ɖe jε ɖe gudo	a role
mεjijε mεjijε	a role
nu sin kan mε	etre au quelquun faire quelque
sin ji	etre le
jε mε ji	etre le quelquun
do	faire le
kpe	faire le complet
mεjijε mεjijε	a
aɖawun	dadresse
huzuhuzwi	tourbillon
xasaxasa	tourbillon
do ya nu mɛ	tourmenter
lilε	tourner
kpan ta	tourner vers
kpe nukun wu	tourner vers
kpan	tourner vers
huzu kpan mε	tourner vers quelquun
do nu	tourner autour quelque
hun wema	tourner
do gudo mε	tourner le a quelquun
ɖe	tourner le cote
nukun	tourner les yeux
fle nukun	tourner les yeux
nyi	tourner les yeux vers
ca mε ko	tourner quelquun
mε ko	tourner quelquun
wla mε ko	tourner quelquun
amija	tourteau
kplεbε	tourteau fait avec les residus des cerises palme
bi	tous
mε tobutobu lε	tous ces la
atin kpo kpo bi	tous les etres
gbebigbe	tous les
yɛhwe bi zan gbe	toussaint
kpεn	tousser
kpεn kpεn	tousser
ka mε mε	dans
ɖaxo hu mɛ bi	etre le tous
agba	a fait
jεn	a fait
kloklo	a fait
kpla mε yi bu	a fait
pεpε	a fait
pεpεpε	a fait
kpoɖo	a fait a
kpoɖokpoɖo	a fait a
pepe	a fait
pepepe	a fait
kpεcεε	a fait mouille
wiwi dudu	a fait
amamu fεεn	a fait
kujεkujε	a fait vieux
degbedegbe	entier
kpete	entier
vεlεε	juste
cεεn	juste au
bi	toute
dinzaanɖe	toute a lheure
zaanɖe	toute a lheure
bi	toutes
kpεn	toux
tagbadudo	le fait du tracas
jε tagba nu nu	tracasser
do tagba nu mε	tracasser quelquun
wa nu xa mɛ	tracasser quelquun
fεn nu mε	faire des tracasseries
mεfunfun	tracasserie faire agir
fεnfɔnumε	tracasseries causees a quelquun
xwa	bave dessechee qui reste apres le sommeil
xwaxwa	bave dessechee qui reste apres le sommeil
ɖuɖuxwa	bave dessechee qui reste apres le sommeil
afɔkpado	semelle
ɖe hwεn	le
ɖe ali	chemin
ɖe yehwin	sentier
xwi	une
tin mε	traduire
hwε	traduire
se gbe nu mε	traduire quelquun
slε	trahir
ze mε yi jo	trahir
gba mεɖee do	trahir
ze mɛ jo	trahir quelquun
mεsislε	trahison
mεslεslε	trahison
sislε	trahison
slεslε	trahison
gbligbli	a fond
xwe gbe	etre daller
ɖo wezun ji	etre courir
xwe	etre deplacer vers
kpo ɖo	etre
lεkanlεkan	le fait trainailler
sεε	trainant
afinhwεkan	trainee
sa lele	trainer
sa mε	trainer terre
dε	trainer les pieds terre
do ayi	trainer les pieds terre
mε	trainer terre
sa	trainer terre
sa do ayi	trainer terre
sa mε	trainer terre
sε mε	trainer terre
bli gbo	trainer velo
afinhwεkan	couleur cendree
nubyaxa	desprit
kan	traits physiques
akwεwema	traite
gbeje	traiter
wa ko do	traiter delicatement
ba ha mε	traiter trop familierement superieur
ba do nu nu	traiter superieur egal
balunlunama	designe qui est tranchant
ɖa	etre tranchant
tikpo	qui pas tranchant
xɔdo	tranchee asseoir le mur
ɖa	trancher
gbo	trancher
sεn	trancher
hwε gbo	trancher differend
gbo hwε	trancher differend
gbo hwε nu mε	trancher differend quelquun
gba xo	trancher une affaire
gbo xo	trancher une affaire
do ayi do	tranquilliser
xo mε huhwε	tranquilliser quelquun
cuɖuɖu	tranquille
ku hun	tranquille
hun ɖo aga	pas etre tranquille
xwii	tranquillement
gedemε	tranquillite
ayijayi	tranquillite du coeur
ayijεdo	tranquillite du coeur
do asa	transgresser
hεn gble	transgresser
do asa sεn	transgresser commandement
gba sεn	transgresser interdit
gba sεn	transgresser une loi
ɖi	etre
hwan	transpercer
xo	transpercer
jε	transpirer
gbatε	marchandise ou fardeaux moyennant salaire a gages
bla gbe	traquer
xo	faire les petits travaux qui presentent
flu	laccouchement
vinu	lenfantement
mεɖe	a lepoque coloniale
gbatε	occasionnel gagner quelque
wa	travailler
tozɔwiwa	le fait travailler le du pays
xo zo ci	travailler a eteindre le
wa kinkan	travailler a tache
tun	travailler artistement les metaux
atin	travailler dans menuiserie
xo zan	travailler nuit
kpa atin	travailler le bois
sin ka	travailler une calebasse
kpa kεn	travers
nyido	travers
gban	etre travers
nui do	etre travers
jlo a	faire travers
zan kpotin	natte ou le matelas
sa	fleuve
flε	une lagune
kpa	une palissade
sa	une riviere
flε	une riviere a
gba	trebucher
klεn	trebucher
mɔ	trebuchet
kikiki	tremblant froid
ayikungban hunhun	terre
kɔxε	trempe
kɔxε	trempe sueur
gi	faire tremper le mais faire le gi
ci ata	tremper dans le beignet
sun nusunnu	tremper dans
kan bo sun nusunnu	tremper pate dans
ci gan	tremper le fer
ci ata	tremper le peigner haricots dans lhuile
gban	trente
saɖexwejεsu	trepas
zinkpo	trepied
kpitikpiti	trepignant
manamana	trepignement
tamatama	trepignement
ki jo	trepigner
sun manamana	trepigner
sun tamatama	trepigner
ɖesu	tres
din	tres
taala	tres
fla ayi	etre tres abondant
hun nukun	etre tres
kpeke nu mε	etre tres fatigue
sin	etre tres
kpεn kpo	etre tres lourd
vivo	etre tres mur
vuvo	etre tres mur
sefunsefun	etre tres
gbelu	etre tres nombreux
tun fla	etre tres nombreux
mya nukun	etre tres occupe
gbi	etre tres usage
kpo kan	etre tres vieux
kakaka	tres tres
dɔkun	tresor
dɔkun	etre tresorier
dɔkun ji	etre tresorier
si nu	tressaillir
ɖanyinyε	tresse
ɖablabla	tresse cheveux
nyinyε	tresse
gbε	tresser
gbε kan	tresser
gin ɖa	tresser artistement les cheveux
ɖa	tresser des cheveux
kan	tresser des
ɖa	tresser les cheveux
bla alin	tresser les cheveux
gbakun	tresser
gbε avokan	tresser une corde
kan	tresser une corde
zan	tresser une natte
xweɖa	tribu qui habitait region ouidah
mε ɖu	tricher
blu	tricher
fin	tricher
fin nu	tricher
fin nu wlan	tricher ecrivant
bluju	tricheur
mεblεɖutɔ	tricheur au jeu
souci	tricotage
nu	tricoter
sefunsefun	trie le
cyan nu	des choses
cyan dekin	les amandes palme
cyan nukun	les grains
ɖo bu	trinite
xwe do	tripoter
xo zo mɛ wu	tripoter quelquun
wu ku mɛ	etre triste
wublawubla	etre triste
ɖo alwε mε	etre dans tristesse
donu	troisieme
mima	troisieme partie
ajinaku	lelephant
lanzo	corne dantilope
lanzo	faite corne dantilope
lanzo	faite corne
blasaa	tromper
bada	tromper
bu ali	tromper chemin
nyido	tromper comptant
nyido	tromper parlant
xo	tromper parlant
flan	tromper parlant
mε ɖu	tromper les a
blo	tromper quelquun
ɖo nu mɛ	tromper quelquun
hizi mε	tromper quelquun
wa xa mɛ	tromper quelquun
wa nu mɛ	tromper quelquun
xo asannyi nu mɛ	tromper quelquun
bɔnyiji	tromper quelquun racontant quoi
bɔnuiji xa mε	tromper quelquun racontant quoi
bɔnyiji nu mε	tromper quelquun racontant quoi
xo mε ɖu	tromper quelquun avoir quelque lui
mεblεblε	tromperie
nuvu	tromperie
yɛɖonumɛ	tromperie
yɛmɛnuwiwa	tromperie
yɛwiwa	tromperie
ahwankpεn	trompette
kpεn	trompette
nuvudoto	trompeur
xo fitifiti ɖe	une trompeuse
gbavi	quete
gbavu	quete
atingoto	darbre
golyo	humain tete et les membres
ɖaɖa	trop
kpludokpludo	facon trop rapprochee
kpe kpo	etre trop
gbla	etre trop
cololo	etre trop liquide
cololwe	etre trop liquide
zun sin	etre trop liquide
hwe sin	etre trop
takin	etre trop pimente
jε	etre trop sale
blo axi nu mε	pas trop marchander
gbla	trop
gεε	trop personne
domε	dans le trou
ayisundo	trou creuse leau ruissellement
kpεndo	trou dou lon largile faire des briques ou des tuiles
biblo	etre
ayigbado	desprit du a peur
hεn blu	etat qui est trouble
ayi gba do	etre trouble
ɖonya	etre trouble
hun zε	etre trouble
gba hun do nu mε	le coeur quelquun
gba ayi do nu	lesprit quelquun
hlun	quelque
gbeso	trouee dans brousse
asuka	choc des rois dabomey
ahwan	soldats
ahwan gɔnu	militaire
kplekple	troupeau
agluza	dans troupeau porcs le achete
nyibu kplekple	troupeau boeufs
kpεtεvi	trousse decolier
su gba nu	faire le femme
vlafonu	trouvaille inattendue
flu	pas avoir trouve objet malgre des indications precises
ba kpo	pas trouver
kpo	pas trouver a marier
kpo	pas trouver a honorablement
ɖe	trouver
jε	trouver
ɖo gbla mε	trouver parmi
ɖo gbla mε	trouver parmi
kinkεn xo	trouver a redire
akwε	trouver largent
nu	trouver recherchee dans une
gbla xu	trouver peu viande los
sun	trouver mois
jε mε ji	trouver mediateur
tεn	trouver
kpa ayi de wu	trouver une a quelque
kpa ayi do e wu	trouver une a quelque
akpε	sorte truelle
agluzasi	truie
hu	tuer
hu mε	tuer
kpεn	tuile
zinxuxo	tumulte
hlunhlun	tumulte
zingidi	tumulte
ɖu zingidi	faire du tumulte
ɖu zingidi xa mε	faire du tumulte
hihi wu	etre
huhwe	etre
mla	etre
mimlan	le fait detre
kukumakwi	le nec
mε ɖe mε ɖe	lun lautre
ɖe jε ɖe gudo	lun apres lautre
tεnwinlεnwin	lun apres lautre
ceɖeɖe	lun derriere lautre
ɖe jε ɖe gudo	lun derriere lautre
finu	quelquun dici
ce	quelquun du meme age que moi
ɖokpo ɖokpo	a
kplikpli	uni
ɖo gbe xa	etre unis
ɖo	etre unis
ɖo	etre unis
ɖo wu	etre unis
ankoo	uniforme deux ou plusieurs personnes
haɖote	uniforme deux ou plusieurs personnes
hate	uniforme deux ou plusieurs personnes
ɖoɖo	uniquement
ɖo	unir
kple	unir
do ava	generation parlant des animaux
cobwe	unir groupe qui opere quelque
gbεmε	univers
kεmε	univers
kε	univers
ɖo ji	dans lunivers
yi	universite
ji	universite
bala	universite
vɔ	universite
ɖo	uriner
hu aɖɔ	uriner
gbla mε	avoir besoin duriner
hun	uriner du
gbo	uriner involontairement
ji	faire lusage
cεkε	usage
ganglija	engin tres usage
do kpo	etre usage
do xo	etre usage
aluku cεkε	tres usage
do xo	etre use
yɛɖonumɛ	le fait duser envers quelquun
zan ayi blublu xa	fourberie a legard
ɖo yε nu mε	envers quelquun
gbidi nu mε	tous les moyens faire parler quelquun
hu do mε	etre a
gbɔjε	vacances
yi azan	avoir des vacances
xo zin	faire du vacarme
gbo abahwε	vacciner
gbo abɔhwε	vacciner
gbo hwε	vacciner
nyibu	encornee
yi zan ji	vadrouille
xo	vagabonder
tɔxuxo	lagune
adan	vaillance
klεklε	vaille que vaille
nyamanyama	vaille que vaille
ɖu ɖo mε ji	etre vainqueur quelquun
mεjiɖuɖe	vainqueur
mεjiɖuɖetɔ	vainqueur
agban	faire vaisselle
kpεn	avoir
akwε	avoir
kwε	avoir
afuyε	peu
wowunkpali	qui napprecie pas les choses a leur juste
ɔ	determinative
gbamε	vallee
gbamε	vallee fleuve
te	valoir mieux
te	valoir mieux
awekikε	vanite
yi go	avoir vanite
kε awe	etre vaniteux
mɛɖee mɛ	etre vaniteux
fle	vanter
vivi	vanter
yi nugo	vanter
sa xa mε	vanter a quelquun
jla nu do mε	vanter quelque a quelquun
agevε	terrestre
hunkpa	rythme dans groupe que seul linitie sait danser
tεnmε tεnmε	varie
sεn	avoir
sεn mε	avoir
sεn sakpata	avoir
ko	dessechee et noiratre
gbεn	terre
sinnugban	qui contient leau boire
ɖoyaɖoya	vaste
gblagadaa	vaste
glijaa	vaste
do agba	etre vaste
aganma	vaudoun
hun	vaudoun
masε	vaudoun
nyagε	vaudoun
yɛhwe	vaudoun
yaoca	vaudoun cango
yaoyica	vaudoun cango
gbadε	vaudoun famille xεbyoso
jakata	vaudoun famille xεbyoso
na	vaudoun fecondite
zunvodun	vaudoun foret
xɛbyoso	vaudoun foudre
gu	vaudoun des forgerons
xweli	vaudoun domestique
ayizan	vaudoun du marche ouidah
xɛbyoso	vaudoun du tonnerre
nakpokisa	vaudoun enferme dans
sakpata	vaudoun originaire region dassa
tolεgba	vaudoun protecteur
tɔbosi	vaudoun qui va queter au marche
ave	vaudoun
avlekete	vaudoun des plages
azli	vaudoun du
akɔvodun	vaudoun
acigali	vaudoun protecteur
agε	vaudoun qui devoile les choses secretes
agbe	vaudoun qui represente mer
atinmεvodun	groupe vaudouns residant dans arbre
bosi	nom vaudoun
hunvε	categorie vaudoun
jivodun	le vaudoun du ciel
jivodun	le vaudoun du tonnerre
aklɔnbε	nom vaudoun
yakpe	nom du vaudoun dan
gede	nom du vaudoun region dabomey
dɔvɔ	nom vaudoun dagonlin
adanvε	sorte vaudoun
atigali	sorte vaudoun
ava	sorte vaudoun
avɔsε	sorte vaudoun
aganmasi	variete vaudoun
ahwansi	variete vaudoun
dan	variete vaudoun
golo vodun	variete vaudoun
kanlingan vodun	variete vaudoun
aɖo	vaurien
nyibuvi	veau
nyibuvi e ɖo jo	le veau gras
kεkε	vehicule avec
agbanhun	vehicule
ayihun	vehicule terrestre
e kpo	veille
nata kpo sɔ	veille noel
sibigbe kpo	veille du samedi
jɔnu	veillee
mεdoalisa	veillee
zohwin	veillee
xwe	faire veillee une fete
xo zan	faire une veillee
jɔnu	faire une veillee
jɔnu	faire une veillee funebre
zan	faire une veillee funebre
paskwa	veillee pascale
aceji	veiller
ɖo ayi te	veiller a
nu do wu nu mε	veiller a pas faire a quelquun qui agit
na jɔnu	veiller et au le soir
zan	veiller une ceremonie vaudoun
ɖo ayi te	veiller
ji	veiller
kpe nukun wu	veiller
mε ji	veiller quelquun
zan	faire les fonctions veilleur nuit
kεkε	velo
ji	a velo
do kεkε	a velo
abititi	epais prix
wu fun	etre velu
kpowɔlɔɖu	une des formes du jeu daji
axisi	vendeur
axisi	vendeur qui fait les marches
sa nu	vendre
sisa	a vendre
sa kpo	pas vendre
ɖi sa	vendre
sa nu nu mε	vendre a credit a quelquun
jla nu	vendre a criee
ɖe sa	vendre au detail
sa kpεkpε	vendre au detail
sa nu tete	vendre au detail peu
fli nu	vendre au prix coutant
sa nutete	vendre menus articles au detail
sa nu tete	vendre des petits riens
ɖe sa	vendre peu a peu
sa kpεkpε	vendre peu a peu
sa ɖu	vendre consommer directement
sa ɖu	vendre quelque
ɖe nu sa	vendre quelque au detail
sa nu nu mε	vendre quelque a credit a quelquun
fli nu	vendre benefice
sa nutete	vendre peu
mεxozan	vendredi
ba mε wu	quelquun
ba nu mε	quelquun
ɖo aɖi	etre venimeux
wa	venir
wa	faire venir
xwe ɖevo	une annee a venir
wa gbe	venir
wa kpe	venir a
wa kpe mε	venir a quelquun
wa so nu mε	venir a rescousse quelquun
do wu	venir apres
jε gudo	venir apres
wa gbε	venir au monde
wa so nu mε	venir au secours
wa mε	venir aupres quelquun
wa	venir dans
sin	venir dans
wa sin	venir
jε	venir devant
sε wa	venir devant
gudo	venir
to	venir
nyi ahwan wa	venir foule
nyi ahwan wa	venir groupe
nyi ahwan wa	venir
nyi ahwan wa	venir
wa nu do mε	venir rendre a quelquun
wa nu do mε	venir saluer quelquun
wa su mɛ	venir mettre sous quelquun
wa	venir vers
wa ba mε	venir quelquun
do nu mε	venir voir quelquun que lon pas vu depuis longtemps
fun	faire du
wooo	venant du sahara
kpan mε	faire premiere vente
adɔmε	ventre
sεli	le
sεli	ventre
wa	etre venu
sasu	ver et dangereux
kandu	petits vers ronds intestinaux
alaxasa	sorte ver rugueux
domεwe	ver
dan	vers
xomɛdan	vers
agba	veranda
do	verifier
nugbonugbo	veritablement
ɖu ya	etre vermoulu
agluzasu	verrat
agluza	verrat
sεxlo	verrou
jεgun	verrue
leε	vers precis
gbadanu	vers le soir
hwe jε tokpa	vers les heures lapres
hwe jε tokpa	midi
huzu	etre
takwε susu	versement limpot
kinkɔn	metal
de mε	dans
do e mε	dans
ba sin	leau terre hommage aux ancetres
ba sin nyi ayi	leau terre hommage aux ancetres
ba sin	leau terre une
ba sin nyayi	leau terre une hommage aux ancetres
ba sin nyi ayi	leau terre une hommage aux ancetres
wun do zo	lencens du
kɔn hun	le humain
dayi	terre
do ayi	terre
nyi ayi	terre
nu do mε	quelque dans
fεεn	sapplique a couleur verte
nεgbexu	vertebre
nukunmεgbazin	vertige
nukun	avoir des vertiges
wunɖawunɖa ɖa mε	avoir des vertiges
nukun gba zin	avoir le vertige
jijɔ ɖagbe	vertu
jujɔ ɖagbe	vertu
ɖo tamε	vertu
awu	vetement
dowu	vetement dessous
nuwamεwu	vetement deuil
bawun	vetement femme avec des manches tres amples
do awu	vetir
asukusi	veuf
vablε	veuf
didε	viande coriace
mu	viande crue
nyibulan	viande boeuf
lan	viande porc
hunɖe	viande donnee cadeau a celui qui tue lanimal
hwesalan	viande du marche
didε	viande elastique
gannumεlan	viande boite
gannumεlan	viande
mu	viande fraiche
susɔ	viande frite
hihi	viande fumee
hihi	viande grillee
mimε	viande grillee
hizahiza	viande rotie
mimε	viande rotie
susɔ	viande rotie
jεmεlan	viande salee
landojε	viande salee
xiyaxiya	viande sechee
gble	vicier
mε gbigble	vicieux
zun mε	etre vicieux
ahwanjiɖuɖe	victoire
togbibga	victoire
do tofwe	etre vide
gblolo	etre vide
kugbegbεgbe	a a
ɖo gbε de	cette
gbεmε fi	cette
ɖo gbε	etre
gbε	etre
ɖo ɖokpo ji	etre entre et
gbε	plenitude
gbε mavɔmavɔ	eternelle
gbε funyafunya	loi
mεkpikpo	vieillard
mεkpukpo	vieillard
mεxo	vieillard
nyaɖaxo	vieillard
nyaxoxo	vieillard
degenɔ kpikpo	vieillard
mεxoxo	vieillard
degenɔ kpikpo	vieillard decrepit
kpo nyɔxo	etre vieille
nyɔɖaxovi	etre vieille
kpikpo	vieillesse
kpukpo	vieillesse
mεxo	vieillesse
ɖɔxwi	qualifie une boisson qui vieilli
kpo	vieillir
mεɖalɔji	vierge
finnifinni	vierge jeune homme ou une jeune fille
ɖo ji	etre vierge
ɖo alɔji	etre vierge
ɖo sε gbe ji	etre vierge
kpikpo	vieux
kpukpo	vieux
kujε	vieux
nyaxoxo	vieux
kpo	etre vieux
degenɔ kpikpo	une vieille personne
nyɔɖaxo	vieille femme
nyɔxo	vieille femme
ganglija	vieux clou
agbawungbaloke	vieux du
aglija	vieux materiaux terre ruine
ɖeɖeɖe	vif
gbεɖe	vif
zin ɖo nukun	avoir les yeux vifs
zin	etre vif
azingblεntεn	qualifie enfant vif
ɖo ayi te	etre
te	etre vigueur
kpo ɖo te	etre vigueur
be	vigueur au rachitisme
nyla kan	vilain
nylanyla	tres vilain
daka	vilenie
toxomε	dans le
glegbεta	groupement villageois
ajala	nom plusieurs villages
domε	nom du aheme
dekanmε	nom
jεgbaji	proche ouidah
tomεnu	villageois
alada	historique lancien dahomey
adanhunsa	nom donne a dalada
ajahɔnmε	une
hwεgbo	au nord dalada
detan	vin du palmier a huile
selitan	vin du palmier dattier
ba	etre vindicatif
ɖokpo	vingtcinq francs
ɖo adan wu	violemment
gblawun	violemment
ɖo wu	violemment
jɔwun	violemment
ɖo adan wu	avec
kan xa mε	faire a une femme
nu	violenter les choses
da alε mε wu	le pacte damitie
da lε mε wu	le pacte damitie
do asa sεn	interdit
kan xa mε	une femme
tlεn mε	une personne
amasukpwε	vipere
amakpwε	vipere a corne
amasε	vipere tres
sεgbeji	virginite
kan	faire perdre virginite a une jeune fille
ɖo	le membre viril
ɖo ji	viser
daan	viser
kpe tu	viser avec
kpe tu lan	viser le gibier
gaan	visiblement
kloloo	visiblement
kpe nu	avoir une
ba jlε	chez quelquun
yi ba mε	chez quelquun
do	rendre
yi jo gbe	rendre
yi nu do mε	rendre a quelquun
do mεɖe	quelquun
jo	visiteur invite
ba mε	avoir visiteur
ble	vite
gliwun	vite
klaxla	vite
kplakpla	vite
kplawun	vite
lewunlewun	vite
tɔ koklo	vite
ɖi blemu	au vite
ya wu	faire vite
gbligbli	a toute vitesse
gbεɖe	vivant
ɖo gbε	etre vivant
gbεɖegbεɖe	vivant
hwεnwun	vivement
nyεwun	vivement
do gbε	vivre
gbεzinzan	maniere vivre
wa nu kwiji kwiji	vivre dans debauche
ayi jε ayi	vivre dans paix
ayi jε ayi	vivre dans securite
jε	vivre bonne
yaya	vivre
jε	vivre
vo	vivre inoccupe
ji	vivre longtemps
akpa	voeu
akpadido	voeu
do akpa	faire voeu
ɖie	voici
nyavi	cet enfant que voici
ali	voie
sunvi wɔɖɔɖɔ	voie lactee
ɖie	voila
enε	voila
nε	voila
kpeto	veux voila
gbεgbε	veux voila
gbεgbεgbε	veux voila
mε ɖe nε	voila
nu e wu	voila pourquoi
nu e wutu	voila pourquoi
nu e wutu we	voila pourquoi
kpεεn	voile
avɔ	voiler tete
mimɔ	voir
mumɔ	voir
nu	voir
ba	voir
ba mε kpo	voir quelquun et pas le trouver
nukun nu	voir clair
nukunnu	voir clair
gba zin	voir
nukun gba zin	voir
nu	voir une extraordinaire
xwekpanu	les voisins
gbe	voix
gbe lomilomi	voix
gbe lomilomi	voix limpide
gbe lomilomi	voix melodieuse
hangbe	voix
gbe lilelile	voix tres
jajo	voler
jε ajo	voler
fin ba	voler des objets que lon cherches
fin wun	voler puisant
fin nu do mε	voler quelque a quelquun
fin nu ɖu	voler quelque et le
ja ajo do mε	voler quelquun
jε ajo do mε	voler quelquun
fin gba	voler pagne vetir
fin nu ɖu	voler une
ajogbε	voleurs
bakpe	qualificatif ajoute au voleur
axansunxo	qualificatif que lon donne a voleur professionnel
awungosu	voleur fieffe
avɔsε	voleur renomme
kpo ayi kpo	volontiers
fεε	tres volontiers
kloklo	volumineux
jo	vomir
slu adanvε	vomir
vi adanvε	vomir
gble	etre vorace
wla nu ɖu	etre vorace
wema nu mɛ	quelquun
mitɔn	le votre
mitɔn lε	les votres
do mεɖe vodun mε	vouer quelquun au vaudoun
ɖo mε ɖoɖo	faire que lon veut
tε	pas vouloir donner
asu	vouloir epoux
gbo mε	vouloir a prix
gbo mε	vouloir absolument
nu	vouloir faire une qui depasse age
do nukunkεn	vouloir obtenir au dela ses merites
hwlεn kan xa mε	vouloir une femme
yi nu mɛ	apporter soutien a quelquun
yi nu mɛ	traiter une affaire
do yi	a moto
yi tomε	a
dan hun	a travers
do kεkε yi tomε	a velo
do yi	a velomoteur
do xujihun yi tomε	mer
mε	hamac
do hun	ou voiture
gbevun	voyou
jε aglaja	faire le voyou
aɖo	nom donne voyou
ayakatayaja	vrac
paakpaa	le vrai
tankpikpi	une histoire vraie
nugbonugbo	vraiment
ganagana	au vu et au su le monde
lixo	au vue
ɖo ɖokpo ji	avoir le meme vue
nukun nu	avoir le sens vue
gbe	vue
kpaa	vulgaire
hwi	yatagan sorte yatagan
flimitin	ylang
baba ayɔnu	yoruba
hunjεdonuji	zele
nukunkpedomεwu	zele
mya nukun nu	etre zele
fun sa	zigzaguer
tɔmyɔ	zona
đo hwenu mawu ɖo	au dieu crea les cieux et terre
ayikungban ɖo kpowun bɔ nu ɖebu ɖo ji tɔn a zinflu xu ayijɛ bɔ yɛ mawu tɔn ɖo yiyi wɛ ɖo	terre etait informe et vide il avait des tenebres a labime et lesprit dieu mouvait audessus des eaux
mawu ɖɔ weziza ni tiin bɔ weziza tiin	dieu que lumiere soit et lumiere
mawu mɔ ɖɔ weziza nu ɖagbe wɛ ɖe weziza ɖo vo nu ablu	dieu vit que lumiere etait bonne et dieu separa lumiere davec les tenebres
e weziza ɖɔ keze bo ablu ɖɔ zan zan ku bɔ ayi azan nukɔntɔn	dieu appela lumiere jour et il appela les tenebres nuit ainsi il eut soir et il eut le jour
mawu ɖɔ tɛnmɛ ɖaxo ɖe ni tiin bo ma nu ɖokpo na ɖo jinukunsin nu ɖokpo na ɖo ayikungban ji	dieu quil une etendue entre les eaux et quelle separe les eaux davec les eaux
nu nyi nugbo mawu blo tɛnmɛ bo ma ɖo ɖokpo ɖo bɔ ɖokpo ɖo	et dieu letendue et il separa les eaux qui sont audessous letendue davec les eaux qui sont audessus letendue et cela ainsi
e tɛnmɛ ɖaxo ɖɔ jinukunsin zan ku bɔ ayi azan	dieu appela letendue ciel ainsi il eut soir et il eut le jour
mawu ɖɔ ɖo ni kple ci fi ɖokpo bonu fi xuxu ni jɛ we bɔ nu nyi nugbo	dieu que les eaux qui sont audessous du ciel rassemblent seul et que le paraisse et cela ainsi
bɔ e fi xuxu ɖɔ ayikungban fi kple ci ɖɔ xu mawu mɔ ɖɔ nu ɖagbe wɛ	dieu appela le terre et il appela lamas des eaux mers dieu vit que cela etait
gudo mawu ɖɔ gbehan kpo atin kpo ni wu kpe ayikungban bi ji ye ni na kwin yetɔn yetɔn bo na yetɔn yetɔn bɔ nu nyi nugbo	puis dieu que terre produise lherbe portant des arbres fruitiers donnant du selon leur espece et ayant eux leur terre et cela ainsi
gbehan wu ɖo ayikungban ji gbehan tɛnmɛ tɛnmɛ wu atin tɛnmɛ tɛnmɛ wu bɔ ye na yetɔn yetɔn bo na kwin yetɔn yetɔn mawu mɔ ɖɔ nu ɖagbe wɛ	terre produisit lherbe portant selon espece et des arbres donnant du et ayant eux leur selon leur espece dieu vit que cela etait
zan ku bɔ ayi azan	ainsi il eut soir et il eut le troisieme jour
mawu ɖɔ nu na weziza ni tiin gbɔn fi bi ɖo jinukunsin bo ɖe keze ɖo vo nu zan ye na nyi wuntun ɖe bɔ e na xwedo do tunwun hwenu azan kpodo xwe kpo	dieu quil des luminaires dans letendue du ciel separer le jour davec nuit que soient des signes marquer les epoques les et les annees
ye na nɔ jinukunsin bo na na weziza do ayikungban ji bɔ nu nyi nugbo	et quils servent luminaires dans letendue du ciel eclairer terre et cela ainsi
mawu blo nu na na weziza ɖaxo wɛ nyi hwe na kpa acɛ nu keze kpɛvi wɛ nyi bo na kpa acɛ nu zan e blo sunvi	dieu les deux grands luminaires le presider au jour et le presider a nuit il aussi les etoiles
mawu ye ɖo jinukunsin bonu ye na na weziza do ayikungban ji	dieu les placa dans letendue du ciel eclairer terre
ye na kpa acɛ nu keze bo na kpa acɛ nu zan bo na ɖe weziza ɖo vo nu zinflu	presider au jour et a nuit et separer lumiere davec les tenebres dieu vit que cela etait
zan ku bɔ ayi azan	ainsi il eut soir et il eut le quatrieme jour
mawu ɖɔ kanlin tɛnmɛ tɛnmɛ ni tɔ mɛ winnini xɛ ni tiin bo zɔn gbɔn jɔhɔn mɛ	dieu que les eaux produisent abondance des animaux vivants et que des oiseaux terre vers letendue du ciel
nugbo mawu ɖo xumɛkanlin ɖaxo ɖaxo kpodo kanlin tɛnmɛ tɛnmɛ nɔ tɔ bi kpo bɔ ye kpe tɔ mɛ winnini e blo xɛ tɛnmɛ tɛnmɛ bɔ mawu mɔ ɖɔ nu ɖagbe wɛ	dieu crea les grands poissons et tous les animaux vivants qui meuvent et que les eaux produisirent abondance selon leur espece il crea aussi oiseau aile selon espece dieu vit que cela etait
mawu xo ɖɛ do ye ji bo ɖɔ ji gba kun bo kpe tɔ mɛ bonu xɛ ni gba kun kpe gbɛ mɛ	dieu les benit disant soyez feconds multipliez et remplissez les eaux des mers et que les oiseaux multiplient terre
zan ku bɔ ayi azan	ainsi il eut soir et il eut le cinquieme jour
mawu ɖɔ ayikungban ni na xwe kanlin tɛnmɛ tɛnmɛ gbekanlin tɛnmɛ tɛnmɛ kpo kanlin tɛnmɛ tɛnmɛ nɔ sa kpo bɔ nu nyi nugbo	dieu que terre produise des animaux vivants selon leur espece du betail des reptiles et des animaux terrestres selon leur espece et cela ainsi
nugbo mawu blo gbekanlin tɛnmɛ tɛnmɛ xwe gbe kanlin tɛnmɛ tɛnmɛ kpo kanlin tɛnmɛ tɛnmɛ nɔ sa kpo bo mɔ ɖɔ nu ɖagbe wɛ	dieu les animaux terre selon leur espece le betail selon espece et tous les reptiles terre selon leur espece dieu vit que cela etait
gudo mawu ɖɔ mi ni blo ɖo mi ɖesunɔ sin mɛ nu ye ni ci mi ɖesunɔ ɖɔhun ye ni kpa acɛ nu hwevi bo kpa acɛ nu xɛ bo kpa acɛ nu xwe gbe kanlin kanlin nɔ sa ye ni kpa acɛ nu ayikungban bi	puis dieu faisons lhomme a notre selon notre ressemblance et quil les poissons mer les oiseaux du ciel le betail toute terre et tous les reptiles qui rampent terre
mawu ɖo ɖo e ɖesunɔ tɔn mɛ e ɖo e ɖesunɔ tɔn ɖɔhun e ɖo sunnu kpodo kpo	dieu crea lhomme a il le crea a limage dieu il crea lhomme et femme
gudo e xo ɖɛ do ye ji bo ɖɔ ji gba kun bo kpe ayikungban ji bo ɛ ɖo acɛ mitɔn hwevi ɖo acɛ mitɔn bo xɛ ɖo acɛ mitɔn bo kanlin ɖo ayikungban ji bi ɖo acɛ mitɔn	dieu les benit et dieu leur soyez feconds multipliez remplissez terre et lassujettissez et dominez les poissons mer les oiseaux du ciel et qui meut terre
e ɖɔ nu ye ɖɔ gbehan ɖo ayikungban ji bo ɖo kwin na bi bo na atin ɖo ayikungban ji bo bɔ yetɔn ɖo kwin bi ye na nyi nuɖuɖu mitɔn	et dieu voici je vous donne toute herbe portant et qui est a toute terre et arbre ayant lui du darbre et portant votre nourriture
ɖokpo na bɔ ye na nyi nuɖuɖu nu kanlin ɖo ayikungban ji bi ye na nyi nuɖuɖu nu xɛ bi ye na nyi nuɖuɖu nu kanlin nɔ sa bi ye na nyi nuɖuɖu nu nu ɖo gbɛ bi bɔ nu nyi nugbo	et a terre a oiseau du ciel et a qui meut terre ayant soi je donne toute herbe verte nourriture et cela ainsi
mawu mɔ ɖɔ nu emi blo bi nu ɖagbe wɛ ye nyi tawun zan ku bɔ ayi azan	dieu vit quil avait fait et voici cela etait tres ainsi il eut soir et il eut le sixieme jour
gbɛmɛ ɔ mɛ wɛ nɔ	dans fais quelque ils avec
nyi etɛ	quoi cela
nɔvi nyɔnuvi atɔngɔ atɔn nyɛ mɛ wɛ ɖe	sœur une fille troisieme personne qui vient apres moi
bɔ xo jɛ asi tɔn	est tombee enceinte
xo ɖe asi tɔn ja vi ji gbe azan nabiɖe	il trois voulu accoucher
bɔ ylɔ ɖɔ ɖɔ mɔ wɛ kwɛ ɖe kun ɖo emi	appele ainsi pas dargent
bɔ ɖɔ ok	et jai
bɛ wezun ɔ kwɛ ɖe ɖo wezun yi gɔn tɔn	quand je suis mis a courir je suis venu chercher largent et jai couru chez
ylɛ katie wɛ nɔ nɔ	je appelee au quartier ou habite
tɛ tuun katie xwe ɖe gbe nɔ nɔ a	je connais pas vraiment le quartier et maison ou habite
ɖo ɖo komisaria ɖe nukɔn	et sest fixe devant le
yi mɔ ɛ	et je suis venu voir
mɔ ɛ ɔ adɔgo tɔn bi	jai vu que ventre est totalement descendu
bɔ mɔ ɛ ɔ ɖɔ je jan ji vi wɛ	vois quelle
bɔ ɖɔ	et jai
ɖe nɛ adɔgo ɔ lɛ yi bi gbɔn nɛ aji bɔ ɖɔ jre ke	ventre est descendu comme ca et que
emi azan tɔn emi lɛ kɔ	propose revenir dans trois
bɔ ɖɔ hwɛ jan ji vi wɛ	et je lui
bɔ ɖɔ xo ɖo finɛ	et parle la
bɔ nyɛ xwe yi gbe ze caki atɔɔn	et lorsque voulu partir je lui remis
bɔ yi	et je suis parti
yi ɔ ayihɔntɔn gbe jɛn telefon sone kakakaka ylɔ ɔ	quand je suis parti seulement le lendemain le telephone sonne jusqua parle
nyɛ tɛ tuun ɖaxo bi ɔ wɛ ɖo ylɔ wɛ	je savais meme pas que grande sœur qui appele
bɔ yi ɔ kpɔn ji ɔ mɔ ɖɔ jre ke ɖo ylɔ wɛ bɔ ylɔ	et quand je suis alle je suis venu voir qui appele et je les rappeles
bɔ ɖɔ jre ke emi ɖo dotoxwe ɖo maternite	et ils mont quils sont a lhopital maternite
ɖe yi dotoxwe ɖokpo ɖo saintjean	quils sont partis dans hopital a saintjean
yi dotoxwe ɔ sagefemme ɖe ɖo finɛ lɛ ɔ	quand ils sont alles a lhopital les sagesfemmes qui sont la
kpɔn adɔgo ɔ bɔ ɖɔ nɛ adɔgo ɔ ci yovozɛn ɖɔhun nɛ aji ɖe	elles ont regrde le ventre jusqua le ventre ressemble a une
kun ji vi ɔ ɖo ɖe	peut pas accoucher ici
wema ɖo ji ɖɔ je maternite	et elles leur ont fait papier aillent a maternite
maternite ɔ wɛ ɖe ɖo	ils sont a maternite
bɔ ze ze yi maternite ɔ etɛ ganxixo	amene a maternite et ca fait meme pas deux heures
vi jɛn ji	accouche seulement enfant
ji vi ɔ ji sunnu vi ɖokpo	accouche enfant accouche garcon
ɖe xwe dotoxwe ɔ hɛn kwɛ ɖebu	lorsquelle allait a lhopital navait pas
ɖaxo wɛ hɛn caki fɔtɔn ɖo alɔ mɛ	grande sœur avait francs
bɔ amasin ɖe wlan ɔ kpo ɖo kwɛ ɖe su ɖo caisse kpo enɛ lɛ kpo bi ɔ	et des medicaments quils ont prescrits est entierement servi a caisse
eyɛ su cobɔ asu ɔ	qui paye avant que mari vienne
asu ɔ caki atɔɔn jɛn ze	le mari est venu et remis que
bɔ lɛ yi bɔ ɖɔ emi	et il est reparti disant quil va revenir
yi bɔ lɛ lɛ kɔ ze kwɛ ɖe su ɔ	il est parti il est revenu et il donne largent que sœur depense
ze	il le lui remis
donk ɔ ɖɔ xɔ	et maintenant ils ont quon va lui donner une chambre
mais sɔ ylɔ nɔ ɔ	mais hier jai appele maman
nɔ ɖɔ jre ke ɖo	mais mere rendue et est rentree a maison
nyɛ su zaanɖe ɔ	moimeme peu temps maintenant
ɖisa yi kpɔn ɖɔ nugbo aji yi kpɔn ɖo xwe ɔ gbe bɔ yi kpɔn vi ɔ	je peux voir est vraiment a maison les voir et venir voir
burkina faso ɖe yi ɔ jɛ ɔ mɛ ɔ	burkina faso quand suis alle quand je suis arrive dans le pays
ɔ mɛ kwiji	le pays est
ɔ mɛ kwiji azɔ azɔ	le pays est le et le
ðɔnkpɛvu ɖe ɖo dɔn lɛ ɖesu ɖo mɔ azɔ ɖo wiwa a	meme les jeunes qui sont labas ils trouvent pas a faire
ɔ mɛ kwiji bɔ yɔkpɔvu lɛ bi sese nɔ ɖo azɔ wɛ nɔ ɖo siga wɛ	le pays est et tous les petits totalite ils ils fument
nyi ɖe elɔ nɔ ɖo xɛsi ɖi mɛ wɛ ɔ	pas comme ici ou ils ont peur des grands
dɔn nyi mɔ a	labas pas ca
mɔ vi kpodo nɔ kpo ɔ mɔ vɛ ɖɔ kpodo nɔvi kpo wɛ	vois fille avec maman croire que grande sœur et sœur
mɛ bi mɛɛ ɔ mɛ ɔ kwiji	le mais le pays est
amɔ biveti wɛ gbɔn bi bɔ mɛ bi sese nɔ ɖo ahan wɛ nyi gbɛ	mais voir des buvettes partout et le monde boit ils aiment trop fete
ðo yedɛ kwɛ yedɛtɔn ɔ gbɛ wɛ nɔ ɖu	eux leur ils aiment faire fete
ɖo ɖu gbɛ wɛ nyi yedɛ	dois feter eux ils sont comme ca
yi ɔ mɛ ɔ mɛ gɔn yi ɔ	quand je suis parti dans le pays personne chez qui je suis alle
kwilar lɛ ɖɔ je emi ja lɛ yi	cular il quil veut partir au
ðe lɛ emi yi ɔ bɔ ɖɔ	comme que veux partir au jai ok
ja yi bɔ ɖɔ ɛɛn bɔ ɖɔ nyɔ	veux partir au et il oui et jai
nyɛ xwe yi	moi je peux pas suivre au
finɛ nyɛ ɖo lɛ kɔ ɖe bɔ eyɛ yi ɔ	la que je suis retourne et lui est parti au
finɛ nɔ finɛ ɖe yi ɔ	la je suis reste la lui il est parti
kwɛ	il donne largent
bɔ hun	et jai pris le
xwe	au pays
mɛɛ byɔ ɔ mɛ ɔ	mais rentres dans le pays
ɔ mɛ ɔ nyɔnnu etɔn lɛ sunnu yetɔn lɛ nɔ mɛ	dans le pays leurs femmes leurs hommes ils sont propres
nɔ lɛ wu nɔ mɛ mɛ wu beninois lɛ	ils lavent et sont propres que les beninois
mɛɛ ɔ mɛ ɖesu ɔ kwiji	mais le pays
byɔ finɛ ɔ ɖo ɖo kwɛ a	et rentres la dois nas pas largent
eo activite ɖebu ɖo finɛ a	peux pas faire dactivite
aktivite towe ɖebu kwɛ jɛ	activite rien avec feras
ɖo kwɛ ɔ activite towe marche	activite va
byɔ ɔ mɛ ɔ ibo lɛ ɛ wɛ sukpɔ	rentres dans le pays il plein nigerians
ibo lɛ wɛ ɖo kwɛ nɔ yetɔn	les ibo qui ont largent ils leur
gbɔn internet	internet
ɖo kwɛ yetɔn ganji	ils ont beaucoup dargent
yeedɛɛ zɔn bɔ	deux
mɔ ɖɔ dɛ ɖesu mɛ mɛɛ ɔ mɛ ɖesu lɛ ɔ	verras queuxmemes sont propres mais les memes du pays
eo nuɖe ɖo finɛ a	il ny rien la
ɖɔ xo ɖo adagbigbo sunnu lɛ tɔn ji	allons parler circoncision des hommes
adagbigbo ɔ sunnu lɛ tɔn nuɖe wɛ nyi bɔ ɖo	que circoncision des hommes une qui est qui
ɖo taji sunnu ɖokpo ɖokpo	est primordiale les
adagbigbo ɔ	circoncision
gbɛtɔ sunnu ɖokpo jɔ ɖo gbo ada	individu male qui nait faire circoncision
bɔ mɔ ɖɔ je mɛ ɖe ke mɛ bi nɔ gbo a	cependant remarquons que des que pas le monde qui
mɛ ɖe lɛ ɔ nɔ gbo ɖo yɔkpɔvu	certains le quand ils sont jeunes
mɛ ɖe lɛ nɔ gbo ɖo mɛxo mɛ	coupent a age avance
mɛxo tawun wɛ nɔ ɖo	ils sont vraiment des adultes ils sont deja a age
xwe ɔ nɔ sɛ yi kpɛɖe	a age deja peu eloigne
cobɔ nɔ gbo	mais ils les coupent
bɔ nɔ wuvɛ enɛ ɔ	et ils sentent douleur
amɔ nyɛ mɔ ɖɔ je mɛ ɖe que gbo ada sunnu ɔ	mais je vois convienne circoncisent les hommes
hɛɛn nɔ xlɛ sunnu ganji	he ils montrent homme
nɔ ɖɔ enɛ sunnu sunnu sunnu ɖie	et cet homme sest rapproche femme a quelle heure
ɖe	il est
bɔ vodun ɔ vodun vodun vodun ɔ jɛ gbe ɖo finɛ ɔ nɔ mɔ ɖɔ ɛɛn ganji	et le vodou qui surgit la voit que oui
nyi jacɔ	lui sied
nyɛ mɔ ɖɔ je mɛ ɖe ke adagbigbo ɔ	et moi donc je vois que circoncision
ɖo nɔ kpɔn nɔ gbo vi mitɔn lɛ ɖo yɔkpɔvu mɛ adagbigbo sunnu tɔn mɛ ɔ	devons attendre circoncire nos enfants age
gbo ɖo yɔkpɔvu mɛ	les couperons dans
hwenu wuvɛ ɔ nɔ mɔ ɖe kpo	la douleur va va ainsi diminuer
ɖo nyɛ mɛ ɖe bɔ ɖɔ xo ɔ	que certains disent maintenant
ɖo xwe yi dibla wɛ ayizɛn cobɔ ɖo ɔ	deja presque ans quand circoncis
wuvɛ enɛ ɔ bɔ ci ayi mɛ	senti une grande douleur et reste dans esprit
bɔ mɔ ɖɔ ɖagbe ɖe wɛ	et je trouve que une bonne
nyɔnuvi ɖe lɛ ɖo kartie	certaines jeunes femmes dans quartier
xwe ɖe nɔ mɔ cobɔ nɔ mɔ xwe ɔ	quon trouve dans une maison avant mienne
bɔ mɛ bi hwii	elles sont toutes nombreuses
mɛ ɖebu sɔ yi yɔkpɔvu su	elles sont des enfants elles ont deja grandi
donk su	donc elles sont deja grandes
bɔ su normaleman	donc elles vont mari normalement
mais ɖo finɛ kpo nɔ ɖɔ mɛ ɖevo xo	mais elles sont la seulement commerer les autres
hɛn eɖee gble tawun ɔ	qui constitue leur grande
ɖo dindin wɛ ɔ	et passes devant elles
mɔ xo ɖe bɔ ɖɔ ɖo towe jɛn wɛ	elles trouveront une histoire parler precisement
bɔ nɔ yi nɔ mɛjɔmɛ	et elles et comme les importants
nyi mɛ ɖe bɔ mɛ ɖe nɔ kpɔn ji sɔ mɔ ɖe	sont des personnes et personne ainsi a elles
mɛme sunnu ɖe nɔ gɔn lɛ ɔ	meme les hommes qui viennent chez elles
sunnu ɖe ɖo nuɖe lɛ nɔ ci gɔn	des hommes qui rien a faire et qui viennent sejourner chez elles
bɔ nɔ kple ɖo finɛ	et elles rassemblent la
mɛɖe ɔ ɖɔ mɛ ɔ xo	et maintenant est la elles parleront personne
mɛ ɔ	et les ont entendu
bɔ byɔ nɔ yi jlɛ	et demandent des explications elles cherchent querelle
bɔ nɔ kple nɔ zun mɛ ɔ kabi xo xa mɛ ɔ	et elles groupent personne ou elles vont bagarrer avec les
ɖokpo ɖe tuun bɔ nɔ	seule savent leur faire
sinɔn fɛti mɛ bi ɖo finɛ ɔ	sinon fait sont toutes des personnes qui resident la maintenant
mɛ ɖebu yi asu xwe jɛ	aucune deja partie dans maison homme jusqua present
ɖo kutɔnu ɔ ɖuɖo mɛ	cotonou
yovo lɛ nɔ ylɔ ɖɔ	les yovos appellent cela
sukpɔ tawun	il beaucoup
wɛzɔn bɔ yɔyɔ emi ze ɖo benɛn ɔ	pourquoi le nouveau president elu au benin
nɔ ylɔ ɛ ɖɔ yayi boni	il president yayi boni
ɖo alɔ ɖo mɔnkɔntɔn ji wɛ ɖuɖo mɛ ɔ	il est mettre qui constitue
wɛ nyi etɛ jɛn wema ɖo fiɖe ɔ	quoi ca consiste veux faire papier quelque maintenant
ɖo wema towe lɛ	et deposer tes papiers
nɔ yi wema ɔ ɔ sɔgbe ganji le co	les papiers ceuxci devraient etre prets
ɖɔ ɖɔ jre kun sɔgbe	ils vont que pas pret
bɔ yi ɖo yiyi wɛ ɖo wiwa wɛ	et faire les allersretours
bɔ zan kwɛ nebiɖe ze	que depenses une certaine somme que apportee
kwɛ ɖe ɖo wema ji ɔ trolo nɔ mɛ	apporte le papier ils personne
enɛ ɔ nyila tawun ɖo bɛnɛn	tres mauvais le benin
gbe ja passeport gbe ja	que veux faire le passeport que veux faire
ze kwɛ ɖe wema ji	mets pas dessus le papier
eɖɛ lɔ ɖesu nɔ ɖɔ	euxmemes ils disent
ze hwan ɖo wema ji jɔhɔn ze wema	mets pas morceau le papier le
wɛ yeɖɛ ɖo ze hwan ɖo wema ji hwan ɔ ɖo kwɛ ɔ nyi wɛ	mettre le papier veut que donnes
ɖo ze kwɛ ɖe ɖo wema ɔ ji cobɔ wema ɔ wu tɔn	dois mettre le papier que les formalites soient faites
mɔ ɖokpo ɔ ɖo militɛ lɛ kponɔ lɛ ɖesu mɛ	meme les militaires les policiers eux aussi
kɛkɛ kun wɛ brule	roules moto brules le
abi hɛn agban ɖe abi ɖo	ou beaucoup bagages ou
ɖo yiyi wɛ	et passes
yi kwɛ caki ɖokpo caki	ils prennent
kpɔn wewe wɛ ɖo ɖɔ hwɛ yi	et ils laissent partir
enɛ lɛ byɔ nɔ ɖo ɔ dɔn ɖo dɔn gudo wɛ	ca qui laisse le pays arriere
bɔ miɖɛ ɖesu tuun	et nousmemes pas compte
yayi boni ɔ enɛ lɛ bi ɛ jan kun enɛ lɛ bi	et yayi boni est venu maintenant toutes ces choses il veut mettre
dawe ɔ ɖo azɔn wɛ tawun ɖo ɔ wu	mais il travaille correctement le pays
azan nabiɖe nɔ nyi aeroport ali ɔ ji dɔn	fois passee parti voie
aeroport ali ɔ ɖo bi	ils ont repare voie
bɔ gba xwe ɖagbeɖagbe ɖe lɛ ɖo aeroport gudo finɛ ɖo xo ɔ bɔ	et ils ont construit belles maisons derriere au mer
eo mɔ ɖɔ kutɔnu ɔ	vraiment vois cela que cotonou change
mɛ ku lɛ ɔ	mais les qui sont morts
yeɖɛ jɛ sɔ mɔ elɔ lɛ	sont eux qui peuvent voir ca la
wɛzɔn bɔ ku ɔ nyi ɖagbe ɖe	pourquoi pas une bonne
ɖo gbɛ jɛn wɛ ɔ nɔ mɔ	voir
fɔn ganji a	reveille
ɖo kɛɖɛ a	bonne sante
enɛ ɖɔ emi danxomɛ mitɔn mɛ	oui que viens au dahomey le ventre du dans notre pays
xwebaja mɛ	dans le pays du xwebaja
xwebaja mɛ ɔ mɔ jonɔ ɔ nɔ yi ganji	au pays du xwebaja trouvons le recevons tres
mɛ yovo anyu wewenɔ lɛ	vous les blancs a peau
mitɔn mɛ ɔ yi ɖo ɔ	vous venez dans notre pays vous recevoir parce
mitɔn lɛ mitɔn lɛ grandpapa	nos grands rois nos ancetres les
wɛ sɔ mitɔn sɔ syan ayi kpɛɖe	deja eux qui ont fonde a notre pays
đe nɔ bɔ nyɔ ɔ wɛ sɔ ɖo	ils fonde correctement tel etre
mɔ ɖo mɔ jɛ mɛ hun	estce que vois que je suis donc
ɖɔ miɖee ɖo agbomey ɔ ɖɔ wɛ ylɔ mitɔn lɛ wɛ xo mɛ	est que parlant nos grands rois qui ont dans le ventre
aɖɔgo mɛ lɛ sɔ xwe ɖo ɖɔ kun nɔ mɔ nukun jɛ aɖɔgo mɛ	dans les ils les ont couvert avec une calebasse disant voit pas qui dans notre ventre
ɖɔ yeɖee nɔ ɖɔ xwegbaja kasudo nɔ hun kpɔn	raconte a propos du xwegbaja kasudo peut ouvrir calebasse
mɔ nukun jɛ mɛ hun mitɔn mɛ ɖo ɔ ɖagbe ɖo	comme ca compris donc que dans votre pays ici il le
akwɛ ɖo	il
bi ɖo	il
mɔ miɖɛ lɛ tɔn lɛ ɔ ɖo kwɛ hu	mais dans votre pays il
ɖo mɔ jɛ mɛ	estce que compris
hun ɛ emi ɔ	donc mais la ou vous etes venus ici maintenant
cɛ emi nɔ tɔn kpo sɔ dɔn	je vous remercie venir labas tres
nɔ ɔ cɛ	et parce que vous venez ici je vous remercie
bɔ bi ɖo ganji lɛ vɔ yi ganji	et vous venez tous ici vous viendrez comme il convient et vous repartirez comme il convient
bɔ ɖagbe hun ali bɔ miɖe bɔ ɔ mɔ bi	et bons vous ouvrira le chemin et vous cherchez venant ici vous le trouverez
ɖo mɔ jɛ mɛ	estce que comprends
hun nyɛ ɔ wɛ nɔ nyi	donc moi je
bɔ gɔn	et vous etes venus chez moi
gɔn ɔ gbe mitɔn ɔ ɖo	lorsque vous etes donc venus chez moi votre venir ici echappera pas
gbɛ ɖo	vous abandonnera pas
sɔ unɖe ganji	que vous prenez faire vous devez le faire
bɔ ku yi gbe bɔ azɔn yi gbe	et que et maladie vous emportent
hun bɔ gbɛmɛ ɖi	donc et votre durera
bɔ wɛ danxomɛ mitɔn tɔn sɔ xlɛ	et qui au du dahomey notre pays ici va montrer
bɔ kpɔn bɔ mɔ jɛ mɛ tɔn	et et que decouvres va
ɖɔ xo	estce que comprends
hun niavy towe herman kpodo brisi kpo	donc tes amis herman et brice
xɔntɔn towe lɛ kpo mɛ lɛ	et les autres amis avec qui
vivi wli yɛyi	fait plaisir et ca
bɔ mɛ ɖɔ le	et que
musee hɔn	dans le musee du
glɛlɛ hɔn	dans le palais du
xwegbaja hɔn	dans le palais xwegbaja
byɔ finɛ ɔ mɔ	rentres la
acɔnu ahenu mɔ kpɔn gbeɖe mɔ bi	tous les habits que jamais vus les verras tous
mɔ gbɛtɔ	voir les morts
bɔ ɖo mɔ gbɛtɔ bɔ ɖo	et ils sont debouts verras des tetes morts posees
mɔ mɔ ajajaxu bɔ ɖo vovo	voir des bras des cotes rangees qui seront groupes
bɔ hɛn ɔ kpla bɔ kpɔn bi ɖokpo ɖokpo	et veut va et verras
hun gbe mitɔn ɔ miɖɛ lɛ tɔn mɛ ɔ xwegbaja kasudo wɛ	donc que vous avez voir ici concernant notre pays celui xwegbaja kasudo
emi ɖo ɔ sɔ jɛ nukɔntɔn ɖo	que entends ici peux pas raconter ailleurs
sɔ bɔ yi ɖɔ mitɔn	raconte ailleurs comme vendu notre pays
mɔ nukun jɛ mɛ	estce que compris
hun đe gbɔn ɔ cɛ	donc lorsque viens ici maintenant je remercie
bɔ yi xwe ɔ mɔ xwe ɖo ganji	et rentres trouver maison comme il convient
mɔ vi ɖo ganji	et retrouver les enfants comme il convient
mɔ asi ɖo ganji	et retrouver femme comme il convient
va	va
đo mitɔn mɛ ɔ vidomɛgɔn xo ɔ nuɖe wɛ nyi	dans notre pays probleme que les enfants frappes
bɔ mɛ lɛ	et ca fait souffrir les
mɛ nɔ ze vi etɔn lɛ mɛ wɛ bɔ nɔ hɛn lɛ ɔ	les qui confient ces enfants a des qui les prennent
bɔn suvan ɔ	souvent
gleta gleta wɛ nɔ gosin kpodo vi etɔn lɛ kpo	ils viennent campagne avec ses enfants
nɔ ze mɛ lɛ ɖɔ nyi hɛn	et viennent les amener a des personnes qui occuperont
bɔn mɛ nɔ mɔ lɛ wɛ	sont des qui deja ainsi
mɛ ɖo akwɛ hɛn vi yetɔn lɛ	des qui pas elever leurs enfants
ɖo vi gege ɔ	et ils ont deja beaucoup
wɛ nɔ ze vi lɛ	sont eux qui amenent les enfants
dɔnk nɔ ci ɖi vi lɛ ɖɔhun wɛ mais nɔ ɖɔ emi a	donc comme vendaient les enfants mais ils disent vendent pas
nɔ ze mɛ lɛ ɖɔ hɛn mɔ nuɖe ze nemi ɖe ji	ils les remettent aux qui veulent occuper trouvent quelque veulent leur donner
dɔnk mɛ lɛ yi vi lɛ mɔ hɛn wɛ sɔ nɔ tɔju vi lɛ ɖi vi yetɔn ɖɔhun normalement a	donc les prennent les enfants ainsi et occupent ils veillent leurs enfants comme normalement
dɔnk ɖebu ɖe ɖo xwe ɔ gbe bɔ ɔ	donc quoi qui trouve a maison et auront a faire
yeɖɛ lɛ wɛ nɔ zɔn	euxmemes quon commande
bɔ vi ɖesu tɔn ɖe yi ji ɔ nɔ nuti a nɔ ɖo xwe ɔ gbe	et leurs propres enfants ont engendres ils leur rien mais restent rien faire a maison
vi ɖo vi ɖe ze ɖo yi gɔn lɛ ɔ	et ces enfants ont amenes a maison
nɔ bi	ils ont a faire
vi lɛ lɛ yi wu fɔn	et les les enfants donc qui reveillent donc pas rapidement
nɔ xo	ils les tapent
kabi vi ɔ hɛn vɛra gba mɔ kabi hɛn	ou pareillementou tient une bouteille et fait tomber
kpɛɖe kpowun ɔ nɔ xo bɔ agbaza tɔn bi nɔ gble	il fait simplement une il est frappe tres jusqua que soit gate
nɔ danu xa vi lɛ donk nyi nuɖe	et ils sont avec les enfants donc quelque
nyɔ nyɔ ɖebu bɔ	et
jɔ normaleman dɔnk	il passera rien normalement donc
togan ɖo kɛ xo enɛ wu	le ouvrir parler
jɛ wezunkan ji	et rapidement
jɛ ayixa ɖewu ji	et a reflechir
bɔ tuun ɖee gbɔn ɖo enɛ ɔ kpɛɖe ɔ	et il saura a faire afin que cette cesse peu
đo enɛ ɔ yi nyanya tawun bɔ ɖo ɖe	cette est vraiment devenue une mauvaise et pas maintenant
hɛn vi gege gbɛ gble	va detruire beaucoup
paske ɖo mɔkɔtɔn xa yɔkpɔvu lɛ ɔ	parce que fait ainsi avec les enfants
nɔ hɛn yetɔn mɛ gble bɔ bɔ su ɔ	ca les traumatise grandissent
enɛ nɔ ci mɛ	cette les dans leur tete
bɔ sɔ nɔ yi gbɛtɔ jɔ gbɛtɔ ɖe ɖo yi normaleman	et ils deviennent normalement ca devrait vrais hommes
dɔnk nɔ hɛn vi lɛ gbɛ gble wɛ	donc ils gatent des enfants
mɛ mɔnkɔtɔn ɖee nɔ yi vi lɛ ɖo nɔ hɛn	ceux aussi qui prennent deja les enfants dans ces endroits et qui les gardent
nɔ ɖo adaka xo xa wɛ	et commettent des mechancetes extremes
ɖo jɛ wli ji	ils doivent etre recherches avec des fusils a etre incarceres
wli mɛ oɖe atɔn mɔ	et quand va le faire avec une deux trois personnes
mɛ kpo lɛ ɔ ɖi xɛsi bɔ sɔ nɔ mɔkɔntɔn	les autres vont avoir peur et feront ainsi
dɔnk xo ɖee nyɛ mɔ ɖɔ ɖo viɖomɛgɔn xo wu ɔ nɛ	donc une histoire que trouvee ces enfants esclaves frappes
axi nɔ ylɔ ɖɔ dantɔkpa	le marche dantokpa
axi ɖaxo ɖe wɛ nyi ɖo kutɔnu	le marche cotonou
ɖo afrika gbeji ɔ bi ɔ elɔ ɖo axi ɖaxo lɛ mɛ	lui aussi est des grands marches
axi ɔ klo tawun	le marche est vraiment
ɖo tɔ	et il est au du
ɖo ɖo noxwe ɖe	et a il est au du noxwe
wutu wɛ nɔ ylɔ axi ɔ ɖɔ dantɔkpa	pourquoi le marche dantokpa
noxwe ɔ ɔ ɖe ɖo noxwe ɔ	au du noxwe il au
bɔ wɛzɔn bɔ nɔ ylɔ axi ɔ ɖɔ dantɔkpa	pourquoi appelle le marche dantokpa
axi ɔ klo tawun	le marche est tres
ɖo axixɔ ɖaxo ɖe ɖo axi ɔ fiɖe tɔ ɖe ɔ kpa	il immeuble a cote la ou est le fleuve
bɔ axixɔ etage wɛ	immeuble a etages
etage atɔn mɔ	trois etages comme ca
wɛ axixɔ co ranga ɖaxo ɖokpo lɛ ɖe	il
cobɔ ranga winiwini lɛ ɖo axi ɔ mɛ kpɔ	et il aussi plein petits hangars dans le marche
byɔ axi ɔ mɛ ɔ	rentres dans le marche
ɖebu ɖe ɖe ɔ ɖo gbemɛ ɔ yi mɛ ɔ mɔ xɔ	que cherches dans monde a acheter rentres dans le marche dantokpa trouver
cobɔ nanzeria mɛ lɛ nɔ lɛ bɛ yetɔn lɛ axi ɔ mɛ	et les du nigeria amenent aussi des trucs dans le marche
nɔ yetɔn kpayɔkpayɔ lɛ	et vendent leurs choses piratees
nɔ	et les vendent
ajotɔ lɛ ɖesu ɖo nɔ axi ɔ mɛ	les voleurs aussi viennent au marche
axi ɔ mɛ nyɔ xwe ɖebu wli	rentres au marche controles
ja ɖo vɛ nɔ xɔ gbe ja	va voler crois viennent acheter
ja gbe wɛ yi	ils viennent voler
wɛzɔn byɔ axi enɛ ɔ mɛ ɔ	pourquoi rentres dans le marche la
wli hwɛ ɖe	dois soin
wli bɔ akpo towe	soin
bɔ wli aɖɔkɛ towe	soin besace
wli towe	soin
bi ɖo xɔ gbe ja axi ɔ mɛ ɔ	et dois etre rapide acheter au marche
axi ɔ mɛ ɔ ɖo sɔ	dans le marche chacun secteur
ɖo sɔ ɖokpo ɖokpo ɖokpo ji ɖe	ils ont leur la
jan xɔ	veux acheter
jan xɔ togbe chaine	veux acheter une boucle une chaine
enɛ lɛ ɔ yi axi ɖaxo ɔ ayixɔ ɖaxo ɔ ɔ	ca la au marche du immeuble
mɔ mɔnkɔntɔn lɛ	trouver ca la
co lɛ yi ranga mɛ ɔ	retournes au
lɛ mɔ mɔnkɔntɔn lɛ	trouver ca la
mɔ ɖokpo ɔ mɔ wɛ ɖe sonusonusonusonu ɖo	meme comme ca que ca trouve
axi ɔ mɛ ɔ nɛ axi ɔ klo tawun	dans le marche qui est tres
ɖe ɖe ɔ byɔ nɛ mɛ ɔ mɔ ɔ	que veux viens dans marche trouver avant
ji ja ɔ gbɔn axi ɔ mɛ	pleut peux pas dans le marche
bɔ nɔ ylɔ azɔ xwe ɖe ɖɔ sojema	et il une societe qui sojema
wɛ nɔ kpe nukun ɖo ɔ wu	qui du marche dantokpa
sojema tike mɔ mairie mɛ lɛ	sojema est partie voir les mairie
bɔ gbɔn axi ɔ mɛ fiɖe ɛ	et eux sont venus mettre des paves dans certains endroits du marche
mɛ fiɖe lɛ kpo ɔ jɛ	mais il reste certains endroits pas fait jusque maintenant
ɖo byɔbyɔ ɔ sojema mɛ lɛ wɛ mɔ mairie tɛn kpɔn kpo lɛ ɔ mɛ ɔ	je demande a que les sojema aillent voir les mairie puissent le reste du dans le marche
ɖo ɔ axi ɔ ci axi ɖaxo axi wɛ	parce que le marche ressemble a marche
ðo ɔ mɛ	parce que le
mɛ nutɛ kpo bɔ mɔ enɛ ɔ mɛ	les que cherches et que pas trouver dans le marche
ɖe ɔ axi ɖaxo ɖokpo wɛ nyi klewun mɛ ɔ	pas le marche dantokpa est marche resumer
ɖo ɖɔ ɖo ɔ wu enɛ	que a le marche dantokpa
edabɔ	au revoir
ðo kutɔnu ɔ ɖa wɔ ɖo alɔkpa	cotonou quand prepare pate fait differentes facons
mɔ atɔn mɔ bɔ nɔ ɖo ɖa wɔ	deux ou trois facons preparer pate
nyi ɖɔ etɛ	voici procede
co ɖa wɔ	avant que prepares pate
ɖo mɔ linfin gbade linfin mɔ	trouver farine farine mais et trouver
wɔ ɔ ɖatin asikɛ kpo gannu lɛ kpo	remuer pate avec les bols
ze wɔɖazɛn ɔ ji	prendras a pate et mettras le
flɔ myɔ	et allumeras le
ze wɔɖazɛn ɔ	et mettras pate le
ɖo wɔɖazɛn ɔ mɛ	et prendras dans a pate
mɛɖe lɛ nɔ linfin ɔ ɖo	certains versent pluie farine dedans
bɔ ɖazɛn ɔ mɛ azɔn ɖokpo nɔ	et dans ils remuent meme temps
nɔ jɛ dindan ji dɛdɛdɛdɛ bɔ	et commencent remuer doucement
ɔ nɔ hun agban	dans
nɔ kpan	et ca devient bouillie
ɔ hun agban ɔ	et quand bouillie
nɔ ɔ kpo	prends bouillie peu et mets a
nɔ kɔn linfin ɖe mɛ bɔ nɔ bɔ nɔ bɔ nɔ	et verses farine dedans et remues remues
bi fo ɔ	remuer
nɔ kɔn ɔ kɔn ɖe kpo ɔ	liquide verses bouillie que avais retiree et a
lɛ bɔ bɔ bɔ ze hwe cɛju afɔtɔn mɔ	a remuer a remuer et minutes
bɔ	et remue et prend une partie
mɔ ɖokpo ɔ lɛ ja wɔ ɖa gbe ɔ	comme ca veux preparer pate
nɔ ji bɔ nɔ ɔ ɖo bɔ ɔ nɔ hun agban	leau le laisse et
ɛ nɔ hun linfin bɔ nɔ ɖevo	et jette pluie farine mais et prend
bɔ nɔ nɔ kɔn ɖo zozo ɔ mɛ	et melange bouillie et dans chaude
bɔ nɔ	et fait bouillie avec
bɔ hun agban	et
ɔ hun agban nɔ kpo bɔ nɔ lɛ ɖa	bouillie prend peu et a et recuit
bɔ nɔ linfin ɖe mɛ bɔ nɔ ɖa	et jette farine dedans et prepare
ɖo alɔkpa mɔ ji bɔ nɔ ɖa ɔ	il deux facons preparer avec
bi fo ɔ ɖo gannu mɛ gannu mɛ	et ca finit cuire vous allez ramasser ca dans le bol dans le bol
bɔ wɔ enɛ ɔ hɛn ɔ nɔ ɖu wɔ kpodo nusunnu kpo nusunnu ɖebu nɛnuwi mɛ	et cette pate peut avec quelle exemple gluante
fevi wɛ	gluante au gombo
wɛ jro bɔ ɖu	legumes qui plaira avec
nusunnu wɛ jro bɔ ɖu	tomates que plairas avec
nusunnu ɖebu	quelle
wɛ nɔ ɖu wɔ ɔ	pate avec
mɛ wɛ	qui
nyɛ wɛ	moi
nyi leonrasta	moi leonrasta
nɛ gbɔn	est le pays
mɔ ɖe ɖo jija wɛ ɔ	vu pluie qui
ji ɖo ji ja wɛ elɔ lɛ mɛ ɔ ji ɔ nyɔ ɖebu a	pluie qui pas
ji ɔ nɔ ja e nɔ ja vɔn mɛ bi e gble	pluie dans les basfonds est gate
ɖo ali ɔ ji	il leau
ɛɛn tlɛ jawe xwe gbe lɔ ɔ tlɛ tuun a gbɔn mɛ jɛn gbɔn	oui essaies venir a maison tentes savoir ou mais dois dans leau
ɖo ɖe gbɔn bɔ gɔ gbɔn mɛ mɛ jɛ gbɔn	peux faire autrement dois seulement dans leau
ɛɛn ji ɔ ɖo ji ja e nɔ ja nɔ kɛn nɔ ja nɔ kɛn nɔ ja nɔ kɛn	oui pluie puis ca sarrete et ca et sarrete
jlo e ɔ e nɔ ɖo e jlo e e nɔ ɖo a nɔ ja mɔ tɔn	veut ca veut pas ca pas et ca vient ainsi
mɛ lɛ nɔ yi azɔmɛ mɔ tɔn mɔ tɔn tuun tuwun ɖe e gbɔn nɛ	les vont au ainsi sait pas sais pas va faire
ɛɛn mɔ mɔ ɖɔhun e ɖo ji ɔ wutu ɔ	oui ainsi que je vu il pleut
mɛ ɖe lɛ nɔ yi azɔmɛ mɛ ɖe lɛ nɔ zɔn mɛ nɔ yi azɔ mɛ	il des qui vont au il des qui circulent sous pluie au
mɛ ɖe lɛ nɔ ci xɔ mɛ	il des qui restent a maison
azizɔnnɔ sixu byɔ ji enɛ mɛ nɛ	celui qui est malade peut pas rentrer dans cette pluie
ahan	ok
enɛ ɖo ploblɛmu ɖebu a	pas probleme
nyɔ se a	compris
ɖɔ ɖɔ jre bɔ flin	avant que vous vous le rappeler
ɖɔ ɖɔ je ke ɖo kutɔnu ɔ ji bɛ ɔ	deja avant que a cotonou pluie
kutɔnu ɔ kun nɔ nyɔ kpɔn	alors cotonou pas a
tɔ nɔ gbɔn bi bɔ ɔ gbɔn bi	il riviere partout et partout
ɖi ɖe kɔ ɖɔ gbɔn ɔ mɔ ɖokpo ɔ ɖo kutɔnu ɔ	comme je avant meme ici a cotonou
mɔto sukpɔ kɛkɛ zokɛkɛ sukpɔ tawun	les voitures sont pas nombreuses les velos les motos sont nombreux
bɔ zemijan zokɛkɛ nɔ sɔ mɛ ɖi ɖɔhun	et le zemijan est une mototaxi
bɔ nɔ ylɔ ɖɔ zemijan	et les appelle zemijan
zemijan lɛ sukpɔ tellement ke kutɔnu ɔ sukpɔ	les zemijan sont tellement nombreux que ca cree plein a cotonou
bɔ jonɔ lɛ mɛ gosin exterieur	et les etrangers qui viennent
gosin yovotɔmɛ fiɖe fiɖe	et viennent partout
kutɔnu ɔ	et viennent a cotonou
nɔ mɔ ɖɔ jre ke kutɔnu ɔ ɖe tawun bɔ ɖesu nɔ ɖɔ	ils trouvent cotonou est et euxmemes le disent
adigban wɛ ɔ gosin	mensonge pars
wli ali bɔ xwe nyi gbe ganxi	et fais comme celui qui va a ganxi
mɔ ɔ bɔ lɛ wu xwe towe bɔ sɔ	comme ca prends a maison et correctement
bɔ xa kɛkɛ ji yi bɔ lɛ kɔ bɔ ze abi coton	et prends mototaxi montes moto ca et la et reviens et prends ou du coton
sunsun nukɔn mɛ mɔ ɖɔ jre ke poussiere nɔ gɔ coton ɔ mɛ	et voir que poussiere est pleine dans le coton
enɛ wutu ɔ ɖo kutɔnu	cela que est omnipresente a cotonou
bɔ enɛ ɔ bɔ jɛ wɛ nɔ ɖe	et ca
bɔ nɔ wu ɖo azɔn jɛ wɛ	pourquoi tombons malades
yi dotoxwe ɔ gbɛtɔ nɔ yawu ɖo xwe nabiɖe bɔ nɔ ku	a les meurent rapidement a quel age
bɔ nɔ ɖo xwe au moins kanɖe mɔ	ils ont au moins ans
bɔ gbɛtɔ ku enɛ azizɔ enɛ lɛ gbɔn ɖo gbɔn ɖɔ xo mɛ miɖe lɛ	et va mourir a et fumee dans ventre
nɔ hɛn azɔn winiwiniwini kpla ɖo ɔ afrika	cela qui amene petites maladies afrique
enɛ wutu ɔ ɖo ɖo ɖiɖɔ gouvernement wɛ	cela fait appel au gouvernement et lui
ɖɔ kpɔn xo ɔ wu ɖo ali lɛ ɖo	regarde les problemes et refait les chemins
ɖo gbɔn bi	il des trous partout
zemijan lɛ ɖesu sukpɔ	les zemijan aussi sont nombreux
bɔ nɔ ɖe hwebinu	et tous les il des accidents
azan nɛ bi ɖi ɛ ɔ ku mitɔn mɛ jɔ ɖe kɛkɛ ɖe bla ɖe	fois passee devant entre deux motos
bɔ mɛ wɛ lɛ bi yi kɔ mɛ	et tous les deux sont terre
wɛ nyɔ bɔ mɛ ɖokpo mɛ ɖokpo eyɛ ɔ hun gba gbe gbɔn bi	peutetre est mais le partout tete
wɛ nyɔ bɔ mɔ mawu xwlɛn	peutetre ils auraont ils seront dieu va les sauver
ze yi dotoxwe ɔ	les amene a
mawu xwlɛn bɔ ci ðo jesuschristus kɔ mɛ	dieu va les sauver et ils rien dans le nom jesuschrist
jan yi	veux
ɔ	jaco
gosin kɛndonu yi dɔn ɔ	et viens kendonu labas
gosin kɛndonu ɖo zemijan ɔ	et viens kendonu et prend zemijan
ze ɔ drowa	le pave
jɛ mɛnotɛn	et arriveras a menotin
jɛ mɛnotɛn jɛ ɔ	commences menotin arriveras au
kuhunu lɛ vɔ ze	kouhounou et prends nouveau
ɖo yiyi ɔ jɛ kasse oto	et continues au casseautos
jɛ kasseoto ɔ	arrives au casseautos
kɔntinwe jɛ akosombo	continueras a akosombo
gosin akosombo ɔ	viens akosombo
ze ɖe	prends le pave
enɛ ɔ trele ɔ yi jɛ bayiɛ	et aussitot du pave arriverons a barriere
jɛ barrie ɔ	quand arrives a barriere
lɛ kɔntinwe yi jɛ gbedegbe	continues a nouveau que arrives a gbedegbe
zɛ gbedegbe wu ɔ	depasses bifurques gbedegbe
yi jɛ fiɖe rayi klan ali ɔ ɖee ɔ finɛ wɛ	debouches a ou les rails separent qui est la
nɔ ylɔ ɖɔ ajaha	cet endroit adjaha
jɛ ajaha ɔ	et maintenant arrives a ajaha
mɔ fijrose ɖee yi ɔ	trouver les paves fidjrosse qui conduisent a
dɔnk ze enɛ ɔ jɛ fijrosse kalver	donc prends les paves arrives a fijrosse calvaire
finɛ mawu ɖo jezu	la fait dieu fait
ɖo jezu nyɛ akluzu ji ɖo finɛ	il donc croix jesus la
finɛ wɛ nɔ ylɔ ɖɔ kalver	la calvaire
jɔ finɛ ɖo ɔ	arrive la
lɛ kɔntinwe jɛ hwenusu	continues a nouveau arrives a hwenoussou
hwenusu ɔ karefur ɖaxo ɖe wɛ	hwenoussou est carrefour
stasiɔn desanz ɖe lɛ vɔ ɖo finɛ	une aboutit la
bɔ zemijan lɛ nɔ kɛkɛ ɖo finɛ gege	les zemijans qui garent leurs motos la sont nombreux
lɛ jɔ yeɖee ɖo lɛ vɔ kɔntinwe	arrives a nouveau
dɔnk jɔ eɖee ɖo ze ɔ drwa ɔ	donc arrives les paves
ɖo yiyi wɛ ɔ yi jɛ ɔ	arrives a
jɛ ɔ finɛ ɔ	arrive a a
ali vɔvɔ ɖokpo lɛ vɔ yi trele	il aussitot une autre voie terre
ze jro wɛ	envie prends
lɛ vɔ kɔntinwe ɔ	continues a nouveau
lɛ ze ali vɔvɔ enɛ ɔ	reprends le chemin
yi	iras euh
nɛ pisin ɖe ɖo nukɔn dɔn	une une devant labas
wɔn pisin ɔ nyikɔ	oublie le nom
togbɛn wala nɔ ylɔ ɔ ɖo togbin	togbin voila togbin
dɔnk jro	donc et veux
bɔ lɛ ɔ	et continues a nouveau
ɖi ɖɔ togbin ɖi km kabi km mɔ	je pense que ca faire ou km
dɔnk zɔnlin ɖi ɔ jlɔ ɖi zɔnlin	donc ou veux
kabi jro ɖo kɛkɛ	ou prends taximoto
yi togbin	et iras a togbin
jɛ dɔn ɔ	arrives labas
mɔ mɛ lɛ nɔ su kpɔ	trouves beaucoup
bɔ nɔ ɖo pisin mɛ finɛ nɔ ɖo wu lɛ	ils sont a et lavent
enɛ ɔ lɛ bi bɔn	tous
jrɔ bɔ ɖi ɔ	veux promener
hɛn yi finɛ	peux la
nɔ	soit a jaco
byɛn kɔntinwe sɔ yi togbɛn	ou continues togbin
mɛ atansiɔn kpɛɖɛ	mais dois faire peu
ɖo kɛkɛ ɖido ɖo elɔ mɛ ɔ	aux conducteurs moto qui rendent la ou il des
nɔ polusiɔn nɔ su kpɔ	il beaucoup
ɖɔnk kɛkɛ ɖe nɔ ɖo azizɔ ɖe tɔn ɖokpo bɔ	donc les motos rejettent tellement fumee
elɔ ɖe bɔ	cherches quelque
nɔ nuɖe lɛ ɖo mɛ ɖo	quelque vendent aux feux tricolores
bɔ nɔ ze su awɔntin	couvrir le nez avec
ɖɔnk xɔ enɛ ɔ ɖokpo	donc achetes
ze bla awɔntin twe enɛ ɔ	que a nez
fime sɔ bi ɔ awɔntin twe mɛ	fumee va rentrer dans nez
ɖo azizɔ lɛ nɔ su kpɔ	il trop fumee
bɔ fwa ɔ ali ɔ ɖesu nɔ ɖo ankɔnbre	et des fois voie aussi est encombree
bɔ mɛ lɛ nɔ su kpɔ	et les sont nombreux
atansiɔn	fais
nɔ xwii ɖo kɛkɛ ɔ ji bɔ yi jɛ ɔ	tranquille moto