sá sὲn dŏ wŭ	peindre
dŏ sὲn	peindre
sá adakpέn dŏ	peindre une maison à chaux
kpεɖé kpεɖé	à
kpεvíɖé	à
zinzin	à
káká yí jὲ gàn ɖé mὲ	à que
aɖì dŏ mε	être dans
wùvέ	être
dŏ aɖì xomε nú mε	faire à quelquun
nú mε	faire à quelquun
ɖŭ kotokítí	donner
xò kàn	donner
xò kévè	donner
kú wŭ nú mε	peiner
kú wŭ nú mɛ	peiner quelquun
sὲn	peinture
ajakátáyajà ayakatayajà gudugudù guduù hannyahannyà kpédè kpedĕ	pêlemêle
ɖè fló ná	peler
flé hăn	peler
flé ză	peler
kpà	peler
xásá	pelotonner du fil
fló	pelure
gbò fló	pelure dorange
jὲ kέn	être penché
ɖò kέn	pencher
jὲ kέn	pencher
nyà	pencher
nyà dò	pencher
gbὲɖέ	pencher côté
gbăn nyà	pencher tête
sí dò	pencher tête
zĕ ɖò	pencher tête
sí dò	pencher
tógbé	doreille
vodúngbe mὲ	semaine
sà dayĭ	pendre jusquà terre
sà dŏ ayĭ	pendre jusquà terre
dŏ kàn nú mε	pendre quelquun
gbέjέ	qui
dŏ kàn	pendre
xó	pénétrer lesprit profond propos
syέnsyέn	pénible
vìvέ	pénible
wŭ	être pénible
sú hwὲ	faire pénitence
sú	faire pénitence
nùlínlín	pensée
tamεlinlin	pensée
lìn nŭ	penser
vὲ dŏ wὲ sín	penser
ɖŏ ayì jĭ	penser à
lín gudó	penser à lavenir
lín	penser à lavenir
lìn sɔgudó	penser à lavenir
agblò	pente descendante
nyà	être pente descendante
agblɔnyinyà	pente descendante
takwέ yíyí	limpôt
hwăn	percer
alì	percer trou faire quelque
yĭ amlɔn	percevoir limpôt
yĭ takwέ	percevoir limpôt
yĭ	percevoir limpôt
atín	perche
bă	perche
kpogὲ	perche
kpotín	perche
bàkέ	celui qui manie perche dans une
akplă	perche cueillir les fruits
ɖò jĭ	être perché
túnεkàn	percuteur du
lă mε	être perdant
bŭ wùn	perdre
εnε ɖò bŭ	perdre
kú ajì	perdre à jeu calcul
kú ajì	perdre au jeu dajì
dăn mε	perdre connaissance
nŭ	perdre connaissance
gŭ àkwέ	perdre largent
hù àkwέ nú mε	perdre largent à quelquun
vĭ amì	perdre lhuile
ɖì hùn	perdre du
ahwàn gblé dó mε	perdre guerre
ahwàn gblĕ dŏ mε	perdre guerre
flé ză	perdre peau plaie desséchée
bà nukúnnú kpò	perdre vue
nukún	perdre vue
và nukún	perdre vue
gblĕ ɖò mε sí	perdre lamitié quelquun
gú mε	perdre le bénéfice
zăn kú dŏ mε	perdre le fil discours
và nukún	perdre les yeux
dà	perdre alcool ou objet à ressort
flé hăn	perdre peau
xò tò	perdre solidité fondamentale
xò tò	perdre stabilité
slá	perdre
cì fò	perdre
sún àɖŭ	perdre une
flé	perdre une partie peau
asɔὲ	sorte perdrix
gblĕ ɖò mε sí	être aux yeux quelquun
daá	père
dεέ	père
asì asú	beaupère
daagbó daágbó dagbó	grandpère
mε	le père quelquun
babà	le vieux père
càcú	être fait à
linfínyónú	péricarpe des graines
nukúnmyá	péril
nyladó	péril
gblĕ	être périmé
sá	être périmé
xlojŭn	détachée
hùnjέvὲ	consacrée au vaudoun
lankàn	utilisée les femmes vaudoun
bebé	perles que les femmes au du
kolijέ	perles qui au
kolijέ	dessus du mollet
nă gbè	permettre
nyì agbàn nú mε	permettre denvoyer à quelquun
tεgbὲ	perpétuellement
àcúkpá	perroquet
kisέ	perroquet
kεsέ	perroquet
kεsέklú	perroquet
ɖakpatɔ	perruquier
ɖè dŏ mε	persécuter quelquun
jὲ gŏ mὲ nú mε	persécuter quelquun
fεnfɔnúmε	persécution
gomεjέnúmὲ	persécution
mεɖedó	persécution
yadónúmɛ	persécution
gàndìdó	persévérance
gàndùdó	persévérance
lìnsyέnsyέn	persévérance
sundidε	persévérance
syέn lĭn	être persévérant
xwè nŭ	être persévérant
ɖŏ kàn dŏ wŭ	persévérer
gbejí	persévérer
nŭ jí	persévérer
jĭ	persévérer
syέn lĭn	persévérer
sìn blùblú	personnage
nyaɖaxó	personnage
mε nukún ɖé jí	personnage
mεdaxó	personnage
alufáà	personnage
mε	personnalité
mε	personne
mε ɖĕbŭ ă	personne
mε tí ă	personne
mε tí ă	aucune personne
mεtún	personne
takúnmὲ	personne et soi
mε sísέ	personne adroite
mɛxó	personne âgée
mε kpukpò	personne âgée
mε xó	personne âgée
mεkpikpò	personne âgée
mεkpukpo	personne âgée
mε ɖagbe	personne aimable
bòmásìn	personne atteinte déléphantiasis
nùɖèkpέnkàn	personne au comportement choquant
nùɖégótegó	personne au comportement choquant incivil
mε vɔvɔ	personne au teint clair
mεjὲká	personne au teint clair
avɔkíjà	personne au
avɔkíjà	dessous
afɔlízĕn	personne ayant orteil relevé et surmontant les autres
mε ɖagbe	personne bonne
mε fífá	personne
mεɖomεkpá	personne confiée à quelquun
nὲsúxwé	personne consacrée à nὲsúxwé
sakpatasì	personne consacrée à sakpata
aklɔnbεsì	personne consacrée à vaudoun
avlekétesì	personne consacrée à vaudoun
lὲgbásì	personne consacrée à vaudoun
măwŭsì	personne consacrée à vaudoun
maxínù	personne consacrée à vaudoun
sakpatásì	personne consacrée au vaudoun sakpatá
awànví	personne cour du
fɔnnù	personne lethnie
gεnnù	personne lethnie gὲn
mεhweglì	personne
bìbí	personne dégourdie
hunɖote	personne destinée au vaudoun mais initiée
sakowungbè	personne devenue inattaquable
sakowungbè	personne devenue invulnérable
mεjɔmε	personne digne
mεjɔmε	personne distinguée
axisì	personne principale est daller au marché
mε xó	personne âge vénérable
mɛ wiwi cwícwí	personne débène
mε tlέlέ	personne élancée
mεɖùaɖĭ	personne empoisonnée
mε mŭ	personne étrangère à groupe
mεxέnŭ	personne évanouie
mε sísέ	personne
awumεnù	personne habillée
mεmaɖomεkannu	personne indépendante
hunsì	personne initiée au vaudoun
nùglònúsú	personne irréformable
mε liyalíyá	personne irrespectueuse
awumεnù	personne
keté	personne ou une le nom échappe
mε fífá	personne paisible
mεsegàn	personne polie
mε bìbí	personne prompte
mɛ dáyi	personne prudente
awĭnyà	personne puissante
klíboto	personne qui orteil relevé au
klíboto	dessus des autres
gbangàn	personne qui aime faire quelque qui dépasse ses capacités
mεsegàn	personne qui chante
mεsegàn	personne qui danse
mεglεnsí	personne qui veut paraître étrangère
mεglεnzín	personne qui veut paraître étrangère
canù	personne quon nommer façon précise
mε bìbí	personne rapide
bòsú	personne riche maléfices
mε sísέ	personne rusée
avɔkíjà	personne
avɔsέ	personne du couvent après séjour
hwεmεsì	personne sous dépendance
mε tlέlέ	personne
mεklogăn	personne très distinguée
mεklogănklògăn	personne très distinguée
akwέnɔ hεjεkὲ	personne très riche
mε ɖagbe	personne vertueuse
lisasì	personne vouée au culte vaudoun
lεnsúsì	personne vouée au culte vaudoun
lὲnsúxwésì	personne vouée au culte vaudoun
anagónù	personne vouée au culte sakpata
sakpatásì	personne vouée au culte sakpata
vodúnsì	personne vouée au culte vaudoun
mεyàyá	une personne ordinaire
nukúnɖéjí	une personne remarquable
takún cé mὲ	nom
bùbú	perte
gú mε	avoir perte dans
nùxixé	perte connaissance
aɖùsúnsún	perte dents
nukúnvívá	perte vue
mε blublú	perturbateur
gblègblé	perverti
mε gbigblé	perverti
hùn	être perverti
hùn sìn	être perverti
gblĕ	pervertir
hὲn gblĕ	pervertir
gblĕ mε	pervertir quelquun
kpinkpὲn	pesant
kpὲn	être pesant
kpinkpὲn	pesanteur
kpὲn	peser
nyὲ	faire
nyὲ	péter
ɖò kpὲ	être
ɖò kpεví	être
hwè	être
hwè sìn	être
kpεkpὲ	à
ayìdèvú	dhomme
kpíwún	et constitué
klóbwé	et
píwún	et solide
píwúnpiwún	et solide
púwùn	et solide
kwínέnkwínέn	qualifie être et qui tient pas
kpεví kpεví	très
kpεví títí ɖé	très
kpεvítítí	très
kpεvítítín	très
títí	très
xisixisi	petitement
nyinya	pétri
nyà	pétrir
nyà lìnfín	pétrir farine
nyà	pétrir terre
nyà	pétrir terre avec les pieds faire une
blŭ	pétrir terre barre
nyà linfín	pétrir pâte
kpεɖé	peu
tíntín	peu
kpukpò	le fait dêtre peu cher
kpεɖé kpεɖé	peu à peu
gbawunjò	peu cher
kpɔcɔnu	peu cher
kpikpɔ	peu cher
azàn ɖé májέmájέ	peu après
kpεɖé kpεɖé	très peu
kpεkpὲ	très peu
kpεví tíntín	très peu
kpεví títí ɖé	très peu
kpεvíɖé	très peu
kpεvítítí	très peu
kpεvítítín	très peu
kpεkpὲ	peu
kpεvíɖé	peu
kέɖέ	peu
kέɖέέ	peu
lagbésogbé	peu partout
làxwé	peu partout
kpεɖé swíí	peu
kpεvíɖé cíwún	peu
kpεvítítí ɖé	peu
tíwún tíwún	peu
dò	peur
jéjéjé	peur
ɖò adohù jĭ	avoir
ɖò adohù jĭ	peur
ɖì xεsì	avoir peur
hù adò	avoir peur
xesì mɛ jĭ	avoir peur
ɖì xɛsì dŏ mɛ wŭ	avoir peur quelquun
ɖì xɛsì nú mɛ	avoir peur quelquun
tá wá	peur que hasard
táá	peur que hasard
dŏ adohù jĭ	faire peur
dŏ xεsì	faire peur
wŭ	faire peur
dŏ xɛsì nú mɛ	faire peur à quelquun
wĭwĭ	qui peut faire peur
nyà bìbí	qui peut faire peur aux enfants
ɖì xɛsì	être peureux
afɔnyɔ é soxù nyi ján tanyɔ vlafò vlavò	peutêtre
aglŭzà gbèmέ	phacochère
gbèglúzà	phacochère
ɖŏ	du
xuta	mer
atínkέnsátɔ	pharmacien
amanɔ	pharmacien traditionnel
wèmáɖíɖé	photographie
ɖè	photographier
ɖè fɔtó	photographier
ɖè mε	photographier quelquun
acagbè	phrases à deux termes prononcées deux personnes différentes
nukúnmὲ	physionomie
caqueter	piailler
kέ	piailler
jĭgà	à deux bouts
àkwέgán	pièce dargent
àkwέtawungá	pièce centimes
àkwέ	pièce monnaie
gankpεkpὲ	pièce monnaie
gankwέ	pièce monnaie
dɔncimὲ	pièce tissu offerte au défunt
akpó	pièce détoffe complète
avɔkpó	pièce détoffe yards
amasinxɔmὲ	pièce où lon stocke des médicaments
avɔɖíɖέ	pièce raccommodée
asá	au
lòkósá	au du roko
afɔkpasúnsúnnú	essuie
afɔkpasúnsúnnú	pieds
afɔligbé	le du
busú	les pieds plats
afɔ lajaà	pieds énormes
fέcà	piège fer
mɔtín	piège oiseaux
kpέn	pierre
awĭnyà agidigbájá	grosse pierre
sénúkwέn	pierre à moudre
sefúnnú	pierre avec laquelle retaille pierre meulière
kέn	pierre à briquet
kέn	pierre à
sé	pierre à moudre
sò kpέn	pierre à tonnerre
hwĕ	pierre calcaire
awĭnyà dòdó	pierre fondation
awìnyáxɔkwέ	pierre
sokpέn	pierre du tonnerre
awìnyáxɔkwέ	pierre précieuse
măwùsínsέn	piété
kì jò	piétiner
kpò	pieu
xwelé	ramier
xwleé	ramier
gbagidikpotín	dinde
nyikpotín nyikpotún	dinde
só likún	du
só agŭ	ligname
xwé	piller une maison
nŭvìvέ	piment
takín xayà	du piment réduit poudre
gbàgbàtákín	piment
gbătakín	piment et
baɖòjĭ	piment et
basíà	piment et
atakín wìnìwíní	piment très
takín wìnìwíní	piment très
atakín cɔkɔsú	piment et
atakín gaga	piment et
takín gaga	piment et
cɔkɔsú	sorte piment très
yaɖayaɖà	très pimenté
aɖŭ	pinces des crustacés
fὲn	avec les ongles
fὲn	longuement
agegé	pioche à une seule pointe
kùn	piocher
kwín	pion le jeu
ajikwín	pion le jeu
kozɔkwέ	terre cuite couleur brune
ajijaxá xá	porcépic
mὲ	piquer
sù mε nukúnmὲ	piquer lenvie des autres
xò tó nú	piquer les bords tissu
atín ɖŏ tè	piquer arbre terre
atín ɖŏ tè	piquer poteau terre
nŭmεmε	piqûre
dŏ nú mε	faire une piqûre à quelquun
nylă hŭ	être pire
kúkúmákwí	pire que le
nyì àkpá	faire
ahóo	tant pis
nubláwŭ	pitié
nùbláwùkúnúmε	pitié
kεnklέὲn	aie pitié
blă wŭ	avoir pitié quelquun
wú nù blă wŭ nú mε	avoir pitié quelquun
blă wŭ nú mε	faire pitié
manahὲn	faire le pitre
ɖò tὲn mὲ	à
gbà	avoir une écolier
jὲ mὲ	être
sὲ	être
sὲ dŏ	faire
nú mɛ	faire à quelquun
agblò	dégagée agglomération
yεhwexɔlì hὲnnu	devant porte église
hέnnu	devant une
aximὲ	du marché
ayĭ fín	balayée depuis veille
ahwanplétὲn	publique
nùzìnzán	rejeté laccouchement
dŏ	auprès
tέ azà	plafonner
jὲ agadá	avoir une grande plaie
jὲ akpà	avoir une plaie
agadá	grosse plaie qui guérit pas
nyὲnyέ	plaie entre les orteils champignons
gbogadá	plaie inguérissable
cákpá	plaie à guérir résistant à tous les médicaments
fεnsútákpé	plaie longle du orteil
hwεjijε	le fait plaindre
kú nù blă wŭ nú mɛ	plaindre quelquun
dŏ gbεví hàn	plaindre
jὲ hwὲ nú mε	plaindre à quelquun
hùnhún nŭ	plaindre
ayikúngban	plaine
gbεví	plainte
gbεviyiyá	plainte
hwεjijε	plainte
nukún mὲ	plaire
jlŏ mε	plaire à quelquun
kó	plût au ciel que
dà ayihún	plaisanter
ayihún xó	plaisanter
hwăn	plaisanter
hwăn mε wŭ	plaisanter
ɖŏ alisá xá mε	plaisanter avec quelquun
hwàn mε wŭ	plaisanter avec quelquun
ayihúndídá	plaisanterie
nùhwìnhwέn	plaisanterie
vέ	plaise au ciel que
awàjíjέ	plaisir
xomɛhunhun	plaisir
gbεviví	les plaisirs
ɖè wĕ	faire
lɔkpò	planche
ajitò	variété planche jeu
dèkán	palmiers à huile
gbaflà	plante
gbagloma	plante
afɔkpákpámὲ	plante du
togbà	plante à épineuse
atín	plante arbustive
gumagbó	plante au ressemblant au gombo et pareillement à faire gluante
kúmásá	plante bulbeuse à fleurs couleur jaune orangé
kúyómásà	plante bulbeuse à fleurs couleur jaune orangé
danmalyá	plante censée éloigner les serpents
gblangwé	plante épineuse
lokpó	plante grimpante les feuilles sont comestibles
amasú	plante médicinale
amasúmá	plante médicinale
xwéflú	plante médicinale apparentée à menthe que lon efficace contre les moustiques
kpɔvεwùn	plante qui porte des épines et les feuilles après choc
danwunkàn	plante qui porte des épines et qui empêche le sapprocher
alomaklú	plante qui ressemble à amavivέ
gbĕlè	plante qui ressemble à amavivέ
tetegúngún	plante qui ressemble à xovέ
dèkínkánmá	plante rampante utilisée aussi le
gbŏwunkájέ	sorte plante épineuse les fruits sont comestibles et les feuilles recherchées guérir du paludisme
akpà	variété plante
anyă	variété plante
agbègbè	variété plante rampante
asábwέsábwέ	variété plante rampante
asɔbókan	variété plante rampante très vivace
dŏ tè	ligname
tùn avà	des pieux surmontés claie
tùn	des pilotis une
jŏ mε dŏ nyì fínέ	là quelquun
tùn dĕ	palmier
dŏ kpá	une haie
kὲ awè	plastronner
kpacakpacà	et
kpábέέ	être
kpέbέέ	être
cὲ	haricots avec ligname et viande poulet
cεká	que lon offre au fá
kpabakpabà	très
atɔxwὲ	construite pilotis
tὲ godo	circulaire
fátὲ	divinatoire le fá
tὲ	curviligne
tatέ	métal
tὲ	le fá
atὲ	tressé très
ɖéɖé	plein
gbágbà	plein
kézè ɖéɖé	plein jour
hwè mὲ	plein midi
hwe mε cíɖíɖí	plein midi
hwemὲ	plein
xu zàn	pleine mer
xuzan mὲ	pleine mer
zàn xóxó	pleine nuit
zăn xóxó	pleine nuit
zăn xwè té	pleine nuit
wù afɔ	pleine santé
gbὲ	être plein
wŭ yă	plein dentrain
kpέn kpó	être pleine
fεε	pleinement
yà avĭ	pleurer
dŏ avĭ nú mε	faire pleurer quelquun
avĭ mɛ	faire pleurer quelquun
vĭ	pleurer à propos
avìyàtɔ	pleurnicheur
avĭ	pleurs
ɖasìn	pleurs
jĭ wlĭ	pleuvoir
ɖè atán	pleuvoir à petites gouttes
gbò ală dŏ	faire des plis le cou
ală	pli du cou
mlă	du
xá asá	les jambes
flí zàn	une natte
mlă zàn	une natte
ɖɔkpέn	pêche
xwè jĭ dŏ	faire plongeon
jὲ mὲ	plonger
tadónŭmὲ	le fait plonger dans une affaire
zĭn dŏ yà	plonger dans le malheur
xwè jĭ dŏ	plonger dans leau
lùn dŏ mὲ	plonger dedans
zĭn	plonger quelque
zĭn mɛ dŏ yà	plonger quelquun dans le malheur
fὲ	ployer
xò jĭ	sous pluie
zò jĭ	pluie saison
gbadεndὲn	pluie
fò	pluie et régulière qui au mois daoût saison sèche
xwejí	pluies grande saison
kεsέzán	caudale du perroquet
fún	doiseau
wèmàtín wèwlàntín	porteplume
sùn kokló	poulet
lέ	du pluriel après les noms adjectifs ou pronoms
hwè hŭ	être que
nylă hŭ	être vilain
kplókádíwún	jamais ça
hú	que
nabiɖé	plusieurs fois
awukpò	dhabit
awukplá	dhabit
bŏsù	dhabit
wèmàsíngló	plastique protéger ou cahier
gàndànú	poids
dεnkpè	poignard
hεntὲn	poignée
alɔkpaxwemὲ	une poignée
alɔfún hwà	jambe
tómέfún	loreille
awàdámέfún	des aisselles
alɔfún	des bras
alɔfún hwà	des bras blancs
afɔfún	des jambes
awɔntínmέfún	du nez
sέlífún	poils du
alɔgusú	poing
cέέ	à
ɖò nă wὲ	être le
jà gbé	être le
kpà hlè	être le devenir mûr
xwè	être le partir
gbὲɖέ	être le tomber
gbà	être le denfanter
azàn	le le élevé
zàn	le le élevé
hùnjέn	pointe
gè	pointe des pieds
sεnufέnú	pointe du chiendent
gbăta	qui tête comme une pointe
xwè	des lattes
ɖŏ kέn nŭ jĭ	quelque
ɖŏ nukún mε jĭ	quelquun
bέcwέ	pointu
xwíɖí	être pointu
ɖugò	poire à poudre
aziígòkwín	pois chiche
aziín gokwín	pois chiche
aɖĭ	avoir
xwá	espèce poisson rivière grosse
anwέ	poisson
gagáɖŏ	poisson à gueule allongées et aux dents pointues très tranchantes
aglŏ	poisson avec des nageoires munies piquants
glwĕ	poisson avec des nageoires munies piquants
sósóglwĕ	poisson avec des nageoires munies piquants
kpokún	poisson mer
gannumεhwéví	poisson
hweví mŭ	poisson frais
hwè susɔ	poisson
gesú	poisson qui vit dans les eaux saumâtres
silì	poisson respirant des branchies et des poumons
lanhúnhwέn	poisson séché qui
cέkὲ	poissons possédant trois nageoires très acérées
agbajá	sorte poisson
sósóglwĕ	sorte poisson avec des nageoires munies piquants
wètĭn	sorte poisson ressemblant au mulet
avŭnhwè	variété poisson
oglŏ	variété poisson
zɔzɔví	variété poisson
atakún	poivre guinée
ɖìɖí	être poli
sí mε	être poli
xɛsì	poltronnerie
animátlὲ	pommade
sεnza	pommade noire extraite civette quon utilise parfumerie
sá nùsáwŭ dŏ	pommader
nyĭglŏ	cannelle
nyĭgwlĕ	cannelle
acɔkan	dadam
hĕnjì	pommelle
hɔnkpákpὲ	pommelle
kajùtín	pommier
jɔhɔndónú kεkέ	pompe à vélo
hùnkúkú	pondération
sɔxwixwe	pondération
ɖŏ azìn	pondre
yɛhwenɔ gán	pontife
gbò	porc
àglŭzà	porc
hanví	porc
àglúzasísá	porc castré
ajijá ajijagbówὲ	porcépic
àglúzaví	porcelet
aglúza wutó	porcherie
àglúzàkpó	porcherie
àglúzawutó	porcherie
dŏ jĭ	portant avec soi
hεnkέn	à porte
tóó	porte au superlatif limplacabilité du
kpakpalifwé	porte branches palmier tressées
tútú	à portée
tútútú	à portée
alɔkpláɖótὲn	à portée
gbatὲ	faire le portefaix
babà	ceux qui grands habits
dŏ gà nú mε	lintérêt à quelquun
gbatὲ	des bagages moyennant salaire faire le portefaix
dŏ afɔkú	malchance
hὲn	le hamac
hwὲ mε	plainte contre quelquun
zyăn yonu	ses fesses saillie
ɖìɖă	tête
kpàn	le
kpàn vĭ	enfant le
dŏ	pagne
dŏ	une chaîne
hὲn agbàn	une
xwè gànzá	une couronne
jὲ àkpá	faire le côté quelquun
nyì ahwàn	foule
nŭ dŏ nú mε	garant quelquun disant quil pas commis faute laccuse
nú mε	garant quelquun disant quil pas commis faute laccuse
gbò gbĕ nú mε	garant quelquun
bàsáhwὲ	porteur
bagbáɖátakín	porteur fouet
xò ganlìn	faire des portions pâte
ajacέ xɔgbonú	portonovo
dŏ gesí mὲ nú mε	faire le quelquun à autre
agudatomὲ	portugal
gbɔjέ	faire une
kpádídó	clôture
kpádúdó	clôture
kpádídó	palissade
kpádúdó	palissade
xwè	être posé
ɖŏ mlὲ	des lignes fond
dŏ	dessus
ɖŏ nŭ wŭ	quelque
kέ xɔ	toiture
zé ɖŏ mɛ jí	les quelquun
ɖŏ ayĭ	terre
ɖŏ ayìkúngban	terre
gbà afín dàyĭ	acte aux conséquences irrémédiables
slé	objet poids quelque
hùn	être possédé le vaudoun
ɖŏ	posséder
ɖò àsí mεɖé	posséder
tíìn	posséder
ɖŏ akwέ	posséder largent
nyì nyibú	être possesseur bovins
sín	indique
wlenwín	possibilité
xú	faire
hùn káká yì	faire
hùn káká wă	faire venir
dexɔmὲ	poste douane
bówúnbówún	poste
gbàvíbówúnbówún	poste
gŭdò	postérieurement
kpán	deuxième terme lexpression
sinzέn	à eau
ahòzέn	teinture
ganzέn	métal
nùɖàzέn	terre
atakíngánnú	métallique le piment
takíngánnú	métallique le piment
tɔyizέn	à
giɖazέn	préparer pâte farine maïs
màgbómὲ	potager
akawúngó	potasse
gbokéwún	potasse
kànmù	potasse
agbanhεntín	poteau
xɔdotín	poteau bois soutenir une
alijlεtín	poteau indicateur
kpɔbiì	potelé
kpɔbikpɔbì	très potelé
lisazέn	poterie vaudoun le culte vaudoun
ɖù	poudre à
yɛlósùn	poudre arbre
ɖadonú	poudre
ɖù	poudre
kilóo	poudre noire et brillante que les femmes emploient souligner leurs cils
atín	poudre médicament traditionnel
atínlínfin	poudre qui du bois rongé insecte
tá nú mε	poudrer enjoliver
kokló wútó	poulailler
kokló xɔ mὲ	poulailler
yì kokló	au poulailler
koklóò	poule
koklósì	poule
avivɔfún blă mε	avoir poule
avivɔfún mε	avoir poule
fún	avoir poule
kokló kɔmalwe	poule au cou
kokló	poule aux plumes parsemées
kokló ajàgblé	poule aux plumes parsemées
kokló ayalakíjέ	poule avec des plumes à rebrousse
sónú	poule guinée
kokló kεɖεkεɖὲ	poule grasse et lourde
kokló ahògbán	poule noire
kokló kpεnkún	poule tachetée
koklóò	poulet
kokló aɖɔwé	poulet
kokló wlanwlan	poulet tacheté
koklósixwέ	poulette
asì	pouliche
abunέka	poupée
amunέ	poupée
tawun tɔn	vrai
takún cé mὲ	personne
bó ná dó	que
tá wá	que pas
káká yi mavɔmavɔ	toujours
kúgbègbεgbè	toujours
tεgbὲ yì	toujours
àglŭzà	pourceau
glàséma	pourpier
lĕè	pourquoi
wŭ	pourquoi
wùtú	pourquoi
wutú	pourquoi
étέ wú	pourquoi
étέ	pourquoi
ɖŏ énέ wútú	pourquoi
énέ	pourquoi
nù é wŭ	pourquoi
nù é wútú	pourquoi
nù é wùtù wè	pourquoi
nyinyɔ	pourri
nyunyɔ	pourri
gbì	être pourri
húhwέ	être pourri
vŏ	être pourri
jὲ vă	être pourri parlant patate
húhwέ	pourrir
jὲ vă	pourrir
blă gbà nú mε	poursuivre
xwè dŏ mɛ	poursuivre
xwè nŭ	poursuivre obstinément
có	pourtant
vέ	pourvu que
kó	pourvu que
kpíkpé	pousser
sísέ	pousser
sέn	pousser
kùn	pousser
tún dŏ	pousser
nyà wă	pousser à venir
dŏ axó	pousser grands cris
dŏ axóxó	pousser grands cris
dŏ cáxóxooó	pousser grands cris
sú cáxóxoó	pousser grands cris
sú cáxóxooó	pousser grands cris
tò	pousser grands cris
aɖŭ	pousser nouvelles dents
dŏ aké	pousser des cris
kpà awòbóbó	pousser des cris joie frappant
kpà àwòbóbó	pousser des cris joie frappant
fàn	pousser des cris plaintifs
ɖù nyɔkwín	pousser des gémissements sourds
dŏ	pousser porte
dŏ nú mε	pousser quelquun à sendetter
bà xó mɛ	pousser quelquun dans ses retranchements
dŏ xó	pousser cri
sὲ dŏ	pousser
sὲ yì	pousser
àfíntúntún	poussière
vùn afúntúntún	faire poussière
koklóví	poussin
agbanhεntín	poutre
kpò	poutre
azakpò	poutre du
atín	poutre médicinale faite avec des plantes
acὲ	pouvoir
acεkpikpà	pouvoir
kpé wŭ	pouvoir
tíìn găn	avoir le pouvoir
ɖò àsí mε	être au pouvoir
ɖò acὲ mε	être au pouvoir quelquun
é soxù nyi	il peut
ɖè hùn	pratiquer une saignée
dὲ	précaution
dŏ	précédemment
jὲ	précéder
sέn	précepte
jlă xó	prêcher
kpitikpitì	précipitamment
kpitikpitì	avec précipitation
kpíkpé	précipiter
nyì	précipiter
kpíkpé mε sín ahohó jí	précipiter quelquun du haut des remparts
dŏ	précipiter
zùn dŏ jĭ	précipiter
wlă	précipiter des marchandises
wlă	précipiter nourriture
dŏ	précipiter vers
jέn	précisément
pέpέpέ	très précisément
ɖè ná	préciser
nŭ	être précoce
ɖayĭ	prédire
ɖŏ ayĭ	prédire
ɖò agbòmέ jí	dans sous préfecture dabomey
kpɔnlà	sous
kpɔnlà	préfecture
kétù	sous
kétù	préfecture au nord du département louémé
kpé mε	être le acheteur journée
kpàn mε	être le acheteur journée
kpé	être le acheteur journée
mεxó	le ancêtre
sέsú	le mari
sunwájĭ	le quartier
sosú	dinitié au vaudoun sò
nukɔngbeví nukɔnví	premierné
tεεtέ	pas lenfant
kpódó	terme lexpression
hunɖezεxwε	première cérémonie
kplókpló	première et dernière fois
kplówún	première et dernière fois
sosì	première fille dinitié au vaudoun sò
azɔn	première fois
sέlá	premières règles
dŏ	premièrement
wlĭ	avoir une saveur prenante
mɛ dŏ wŭ	quelquun comme soutien
dŏ wŭ	quelquun considération autre
gbò mε dŏ	quelquun délit
dŏ mὲ	ses jambes à cou
dŏ gè mὲ	ses jambes à cou
xwè	ses précautions
kpé nukún wŭ	soin
bò	soin quelquun
hὲn mε	soin quelquun
kpé nukún wŭ	soin veiller
vò	temps
xwè	temps
gbò dŏ	le fait
nylă nukúnmὲ	sévère
lὲ fá	rituel
alì jĭ	chemin
jὲ alì jĭ	chemin
wlĭ alì	chemin
vĭ	enfant poitrine
vĭ ɖŏ	enfant poitrine
vì	enfant les genoux
nù amasìn	médicament
jὲ nyĭ	nom
gblă	peu nourriture
ɖù kwín	pion
wlĭ ɖáyi	propos au sérieux
dŏ hŭn	véhicule
dà nŭ	une considération
nŭ hὲn dŏ wŭ	une considération
wŭ	une
wŭ	une savon éponge
dŏ kún mε	une femme dans une famille bonne
kán	une pâte
kán	une quelque
kán kpò	une partie du
ɖè fotó	une
ɖè nŭ	une
dŏ xomɛslá	une
nù xomɛslá	une
kpé nukún wú	pas soin
dŏ ayì mὲ	à coeur
dŏ gbatὲ	à gages
kíyà	au sérieux
kplá	avec soi
mε dŏ nŭ wŭ	conseil quelquun quelque
ɖŏ azăn nú mε	avec quelquun
wŭn	farine dans tas
wŭn	poussière dans tas
ɖè hwὲn nú mε	lavance lui
ɖè hwὲn nú mε	lavance quelquun dans une tâche quelconque
bà	leau
bà sìn	leau
wŭn sìn	leau
wŭ	lembonpoint
ɖe mὲ	dedans
ɖò mὲ	dedans
kpà sìn	délicatement le dessus du liquide
kpà amì	délicatement lhuile palme à leau
ɖè alì	des chemins différents
nŭ	des choses une à une
yì kpámὲ	des soins propreté intime
lanmὲ	du
wŭn	du dans tas
wlĭ hwevi	du poisson
wlĭ kpó kpó	délit
dà asì	femme
gbé yawó	femme
kplá asì	femme
wà asì nŭ	femme
yĭ asì	femme
dŏ ayì	garde
nŭ nú vodún	bête ou laliment déjà préparé et lémietter aux pieds du vaudoun
timáti hwεkàn	couleur tomate
yĭ mεsì	femme dautrui
yĭ mɛ asì	femme dautrui
kpá	fuite
gbà gàn	fuite prisonnier
mε tὲn mὲ	quelquun
dŏ jomεhún	lavion
fέ dŏ	le départ
lŭtù mὲ	le deuil
gblă	le goûter
fέ dŏ	le
ɖú gbadá nŭ	le
nù vodún	le vaudoun à témoin
mε	les jambes à cou
dŏ mε	lhabitude
dà asú	mari
yì asú xwé	mari
dŏ wŭ	modèle
sá kán mε	quelque à quelquun qui pas payé dette
sá axì	quelque au marché
gbò sosí	quelque cachette le
gbìdí nú mε	quelquun à
gbè nú mε	quelquun à
ɖè kpá mε	quelquun à lécart
mε ɖŏ tè	quelquun à témoin
mɛ dŏ wŭ	quelquun comme auxiliaire
sέ nyikɔ	prénom
sέnyí	prénom
wὲnnyí	prénom
azàngbényí	prénom correspondant au jour dans semaine
nŭgbomε	préoccupation
gbò mε	avoir des préoccupations
myă nukún	préoccupé
yàyá	nêtre pas préoccupé
hὲn hŭn nú mε	préoccuper
myá nukún	préoccuper
ɖŏ hŭn mὲ	préoccuper
kíyà	préoccuper
blŏ ɖŏ	préparer
nŭ	préparer
sín	préparer certains récipients évidant lintérieur
kpàn anyà	préparer purée
hiza làn	préparer viande
ɖà hùn	préparer des
ɖà hùn	protéger quelquun
gŭ	préparer des maléfices
ɖà hùn	préparer du loffrir au vaudoun
ɖà ɖù	préparer et
xò adăn	préparer bouillie maïs faire pâte
xò kókó	préparer bouillie maïs boire
ɖŏ zàn nú mɛ	préparer natte à quelquun
ɖà nŭ	préparer nourriture
bà	préparer pâte gari
tέ bà	préparer pâte gari
ɖŏ távò	préparer
jlă ayĭ ɖó	préparer le
jĭ galí	préparer gari leau dessus
ahwannú	préparer le nécessaire guerre
tέ távo ɖaxó	préparer festin
ɖà hùn	préparer une cérémonie spéciale
fùn mă	préparer une espèce aux feuilles légumes
ɖă	préparer une nourriture
blă agbajá	préparer à battre
blă akpà	préparer à battre
nŭ xwè	préparer
ɖiblà	à peu près
kέnnέkέnnέ	près
fí	près
tófí	près
tútútú	près
ɖŏ mε	près
yɛsù	du fá concernant tel vaudoun
nùnìná	présent
hwenu è mĭ ɖè	à présent
nùwámεgbedómὲ	présentation des condoléances
xwíxwlé măwŭ	présentation des offrandes le à dieu
xwléxwlé măwŭ	présentation des offrandes le à dieu
nùxwléxwlé	présentation des offrandes à vaudoun
nùxlέxlέ	présentation des pagnes au cours cérémonie funèbre
nùɖé xwlé mɛ	présenter
xwlé nùɖé mɛ	présenter
kplá mε yì xlέ mε	présenter une personne à une autre
kὲ	présenter les entrouvertes
dŏ nùwámεgbè nú mε	présenter ses condoléances à quelquun
xò gbè	présenter ses hommages
bὲlĭ nú mε	présenter ses respects à quelquun
xò gbè	présenter ses respects à quelquun expérimenté
xò gbè	présenter ses respects à devancier
jŏ avalú mε	présenter ses respects à maître
xò gbè	présenter ses respects à maître
xò gbè	présenter ses respects à supérieur
jŏ avalú mε	présenter ses respects à supérieur
mɛɖéé mɛ	présenter à quelquun
ɖŏ tè	présenter à une pouvoir trop attendre
xwè	présenter inopinément
hwlĕn găn	préserver
benέ	le président du bénin
gbὲnùgán	président
ɖù găn	présider
ɖiblà	presque
kέnnέkέnnέ	presque
blă dé jí	presque
vlivlivlì	presque nuit
vlivlì	presque
vlivlivlì	presque
dŏ	être pressé
vò	pas
ɖì	le pas
ɖì zɔnlìn	le pas
zĕ	le pas
sín mὲ	faire sortir
jigán	faire sortir une chique
xò asán nú mɛ	quelquun obtenir une faveur
xò nú mε	quelquun obtenir une faveur
yovózὲn	une
zĭn	pressurer
àcéjí	être prêt
gbè	être prêt
yă	être prêt
zĭn	être prêt à laccouplement
zìn nέ	être prêt à laccouplement
wùyámɛ	prêt à laction
àkwέnyánúmε	prêt dargent
àkwέnyínyá	prêt dargent
nŭ	prêt à tous les mauvais coups
enyíì	prétend que
gangannagansú	prétentieux
gbà vă	faire le prétentieux
cejíjέnnágbóɖó	prétention
nùnùklájέ	prétention
sà àkwέ nú mε	prêter à intérêt à quelquun
nyà nùɖé nú mε	prêter à quelquun
ɖŏ tó tè	prêter
nyà àkwέ nú mε	prêter largent à quelquun
ɖŏ tó	prêter loreille
wlĭ tó wŭ	prêter loreille à propos
hwĕ nŭ nú mε	prêter quelque à quelquun
nuxayatù	prêteur
badékánmà	prêtre du vaudoun badé
yɛhwenɔgăn	prêtre responsable paroisse
nú mε ɖayĭ	prévenir quelquun
nùglònú	préventif ou remède contre les effets nocif
nùnywέɖáyĭ	prévision
lìn ɖáyĭ	prévoir
tuwùn ɖayĭ	prévoir
tuwùn dáyĭ	prévoir
tuwùn ɖŏ ayĭ	prévoir
ɖŏ nùɖé sín kpasìn	prévoir quelque
kpasìn	prévoyance
lìn sɔgudó	être prévoyant
xò ɖὲ nú mε	quelquun
sà vò nú mε	quelquun
ɖεgbè	prière
ɖεxixo	prière
ɖεxuxo	prière
ki	faire prière parlant des musulmans
kantaɖugùdóɖὲ kantaɖugùdósínɖὲ	prière postcommunion
yɛhwexixa	prière vocale
kpɔnuwá	nom
ahwlikpɔnuwá	dabomey
ɖò jí	principalement
ɖòtají	principalement
sέ	principe
asúfánmε	prise contre le gré du propriétaire
fún	priser
sὲn gàn	faire
ganmεnù	prisonnier
gbawunjò	à vil prix
kpɔcɔnu	à vil prix
àkwέ	avoir du prix
kwέ	avoir du prix
àkwέ	être prix
kwέ	être prix
blŏ axì nú mε	faire prix à quelquun
nŭgbomε	problème
gbò mε	avoir des problèmes
hwεɖiɖɔ	procédure
hwὲ	procès
hwεɖiɖɔ	procès
mεnɔzò	prochain
yă	être proche
sὲ	être proche
sὲ mε	être proche
sὲ yă	être proche
kέnnέkέnnέ	proche
tútú	proche
tútútú	proche
jí	proclamer
jlă xó	proclamer
xò mlă mɛ	proclamer ses louanges
ɖŏ gbɔn tomὲ	proclamer édit
akwέ gúgú	prodigalité
àkwέgúgú	prodigalité
ayòɖuɖu	prodigalité
nùzàndóyamὲ	prodigalité extrême
bòjlὲjlὲ	prodige
nŭ baɖabaɖa	prodige
nùjìjlέ	prodige
nùjíwŭ	prodige
nùjlὲjlέ	prodige
hùn bŏ	faire des prodiges
nùywέ	prodigue
gŭ	prodiguer
dŏ tè	produire
ɖì	produire
sí	produire fumée
sέn	produire des fruits
kεcεὲ	produire abondance
fyε	produire brûlure
jì zò	produire brûlure
ɖì	produire effet
jà	produire uniquement les fruits du palmier à huile
hwìnhwán	qui produit comme le maïs
ɖu sù nú măwŭ	une sainte
adăn	proférer des menaces
adăn nú mε	proférer des menaces contre quelquun
ahwàn	proférer des menaces guerre
sà bŏ	proférer une
sà bŏ gbè	proférer une
ɖù lè	faire des profits
dŏ nŭ wŭ	pas
dŏ wŭ	pas
tá afú mε ɖù	quelquun
ɖù afù	aubaine
nyalínmε nyalínmὲ	profondément
gúnmígúnmí	profondeur
zunta	les profondeurs forêt
nukɔnyiyi	progrès
gbìgbέ	prohibé
kpasìn	projet
ɖŏ nùɖé sín kpasìn	faire le projet quelque
ɖè wĕ	faire projet
dăn hùn	promener
ɖì sà	promener
àkpá	promesse
dŏ kplí	faire une promesse sous
kplídúdó	faire une promesse sous
kplí	promesse sous
kplíɖíɖé	réalisation promesse faite après
dŏ akpá	promettre
glíwún	promptement
mε lέ	pronom
ἐ	remplace le pron pers personne é après lélision voyelle ouverte
hwεɖiɖɔ	prononcé
sà bògbé dŏ mε	prononcer des paroles incantatoires contre quelquun
bŏ	prononcer des paroles magiques
sà bŏ	prononcer des paroles magiques
hwὲ	prononcer jugement
dŏ nùbyáxà	prononcer une mémorable
ɖŏ hwὲ nú mε	prononcer une contre quelquun
bɔlŭ	prononcer une
fúnfún kpé	propager
fúnfún kpè	propager
amaxuxò	prophète
mεsέdó	prophète
wɛnsagùn	prophète
ɖayĭ	prophétiser
ɖŏ ayĭ	prophétiser
gbevέsin	propos durs
gbevέsin	propos rudes
gbevέsin	propos secs
mìmέ	propre
wŭ	être propre
zìn wŭ	être propre et soigneux
céké	proprement
mìmέ	propreté
nyì làn	être propriétaire du bétail
aglì	propriétaire acteur histoire
kpolijijε	prosterner
dŏ dò	prosterner
xwè dò	prosterner
xwè sú dò	prosterner
nú	prosterner devant le
dŏ dò nú mε	prosterner devant quelquun
dŏ dò nú	prosterner devant quelquun baisant terre
ɖùbálὲ	prosterner à ventre
ɖè nú mε	prosterner le contre terre devant quelquun
awùngósú	prostituée fieffée
dăn tò	prostituer
lὲ àgà	prostituer
nyà tò	prostituer
mε	être le protecteur
jὲ gblŏlŏ mὲ	pas avoir protecteur
nà	protecteur maison
nyì	protéger
nú	protéger quelque
ɖŏ mε jí	protéger quelquun
nú	protéger quelquun
mε jĭ	protéger quelquun quon découvre pas
xέ	protéger maladie faisant rites lempêcher dy entrer
hwè	protéger du
anwέ	poisson respirant des branchies et des poumons
sín	provenir
wă sín	provenir
xó lógwélógwé	proverbe
ɖὲ wú	providentiellement
nŭ dŏ	provoquer
cí tè	provoquer
tὲ jĭ	provoquer
hìhí wŭ	provoquer des démangeaisons
hù winnyá gbò	provoquer honte
kpácá	provoquer le doute
dŏ vέ nú mε	provoquer linsomnie
ɖè dŏ mε	provoquer quelquun
bà mε	provoquer quelquun
bà mεmε mε wŭ	provoquer quelquun
bà xó mɛ	provoquer quelquun
bà hùn	provoquer quelquun à bagarre
bà hùn mε	provoquer quelquun à bagarre
bà mε	provoquer quelquun à bataille
bà mε	provoquer quelquun à querelle
ɖè xò	provoquer avortement
ɖè xò nú mε	provoquer avortement à quelquun
mɛ	provoquer
dŏ zò	provoquer incendie
sέ dŏ mε	provoquer une maladie contre quelquun
dŏ mε	provoquer volontairement une maladie à quelquun
nukúnyὲ	loeil
akínkɔǹtín	variété prunier
aɖùwúsángà	glabre
ɖŏ gbɔn tomὲ	publier
gbà xó ɖó	publier
gbà xó kpé	publier
jlă xó	publier des nouvelles
nŭyà nú mε	publier les misères quelquun
ɖò wèjí	publiquement
jigán	pénétrante
gusú	pugilat
dundùn	puiser
dùn	puiser dans puits
dùn	puiser dans une
dùn	puiser dans une rivière
xò sìn	puiser leau
dùn sìn	puiser leau puits
wŭn sìn	puiser leau récipient
dùn sìn	puiser leau citerne
dùn sìn	puiser leau
wŭn dŏ	puiser finir remplir
wŭn	puiser remplir récipient
wŭn	puiser liquide dans récipient qui est à portée
ɖĕe	puisque
ɖŏ	puisque
kεnnεsi	et contre
kεnnεsi	attaque contre les sorciers
lĭ	être
tíìn gègé	pulluler
tíìn sù	pulluler
asàn	pulpe lorange
tó nú mε	punir
dŏ yà nú mɛ	punir
ɖŏ hwὲ nú mε	punir
tó nú mε	punir quelquun
ɖŏ hwὲ nú mε	punir quelquun
mεɖomεkpá	pupille
fɔngbe akú	fongbé
fεὲn	très
kpannyà	purée
ayikúnkpínkpán	purée haricots
anyà	purée digname avec lhuile
mìmέ	pureté
sέgbéjí	dans pureté originelle
amasú	purgatif
amasúmá	purgatif
masinslă	purgatif
lεmέzo	purgatoire
lεmέzo mὲ	au purgatoire
dŏ slá nú mε	quelquun
tò	localité
nú hwὲ	toute iniquité
caklógósú	famille des dangbé
cáògosú	famille des dangbé
donu εnὲ	le
tíwún	toute quantité
tíwún tíwún	toute quantité
tiwùn	très grande quantité
cέnwúncέnwún	très quantité
kwín	quantité
alɔgogwè	quantité que les deux peuvent contenir
atέn	une quantité
góɖògóɖwé	une quantité
akwέ hohún	une quantité dargent
alɔkpáxwí ɖé	une toute quantité
tíntínvíɖé	une toute quantité
alɔsέxwì	une très quantité cacher les lignes
cέnwíncέnwín	très quantité
báyí	grande quantité
gboblí	grande quantité
gbógbó	grande quantité
kεcεὲ	grande quantité
tobútobú	grande quantité
wɔgɔò	grande quantité
gbidiì	quantité
yaɖaɖà	quantité
yaɖayaɖà	quantité
akwέ kanɖé	quarante cauris ou
kanɖé lisà	quarante et
dĕgbà wŏ	quarante
slaá mὲ	quartier
slaá mὲ	dans le quartier
fɔn slaá mὲ	le quartier des
gbεndò	quartier dabomey
akpafέn	quartier
ahwanslá	quartier larmée
síngbómὲ	quartier ouidah
agblomὲ	quartier situé au
agblomὲ	ouest abomey
gbεkɔn hunlì	quartier dabomey
gbεkɔn xwégbó	quartier dabomey
akwέ afɔwè	cents cauris ou
akwέ dĕgbà	cauris
kanwè	vingts
kanwe wŏ	vingt
kanwe wŏ	dix
ɖĕe	que
tó	est que est que
ahóo	que sais
ahóo	je
étέ	quelle
nàhún	quelle espèce
tέ	quel
nàhún	quel au juste
akóbá tέ ɖíè	quel malheur
tέ	quelle
ɖĕbŭ	quelconque
hweɖĕnu	quelconque
fùn mε	faire voir quelquun
fí ɖĕ	quelque
káká azàn ɖé ná jέ	quelque temps après
mε nabíɖé nabíɖé weɖé	quelquesuns
mε ɖĕ	quelquun
memú	quelquun qui faisait pas partie du groupe
nabiɖé	quelquefois
nŭ	quémander
avɔkangbεtín	quenouille
hwεgbe	querelle
jlὲ	querelle
jlὲ	quereller
bà nŭ mε	quereller avec quelquun
mε	personne il été
kàn	questionner
kàn mε	questionner quelquun
kàn nùɖé mε	questionner quelquun quelque
xwè gbé	quête
gbò	faire quête des funérailles le cercueil
akwέ	quêter
kwέ	quêter
nŭ	quêter
ɖĕ jὲ ɖè gŭdò	à
nyibúsí	boeuf
vă	des oiseaux et des poissons
ɖĕe	qui
àcéjí	être le qui
mε ɖĕ ă	quiconque
keté	quidam
azăn ɖò sunzán mὲ	le quinzième jour du mois
asì	femme
sín	endroit
anyí	quoi
aní ò	quoi
éŏ	quoi
nù tέ	quoi
tέ	quoi
táánsín	quoi
tántánsin	quoi
ò	quoi donc
ɖekpò	rabais
ɖiɖekpò	rabais
kpɔcɔnu	au rabais
ɖè axì kpò	faire rabais
tέ ɖà	rabattre les cheveux
píwúnpiwún	râblé
atínxwlέnú	rabot
nùxwlénú	rabot
atín	raboter
kacakaca	raboteux
kéjèkéjè	rabougri
avɔɖíɖέ	raccommodage
kpíkpé	raccommodage
nùɖíɖέ	raccommodage
ɖiɖέ	raccommoder
fέ nú mε	raccompagner quelquun
nyì mε	raccompagner visiteur
blŏ ní ɖi gà	raccourcir
blŏ ní hwè glì	raccourcir
ɖè gaɖiɖi kpò	raccourcir
bεlì	raccourci
kún	être bonne
nylă kún	être mauvaise
dòkó	racines familiales personne
flé	racler
kínkέn	racler
xwlέ anyŭ	racler peau brûlée ou ébouillantée
jàxwlέ	raclure
gìjáxwlέ	raclure pâte farine maïs
blŏ ɖŏ	raccommoder
kpì	raconter
wlĭ	raconter
tankpikpi	le fait raconter avec les histoires du temps jadis
tankpikpi	le fait raconter les secrets propre famille
bà nùɖé	raconter des boniments
kpà xó	raconter des histoires
cyán nŭ	raconter détail une
xóglé	raconter une histoire dans tous ses détails
bĭ	râfler
sá kán mε	râfler quelque
fá mὲ	rafraîchir
fá	être rafraîchissant
fá mὲ	être rafraîchissant
kpinkpan	ragoût
syέn kàn	être raide
slamὲ mε wŭ	railler
slamὲ mε wŭ	railler quelquun
mεkiko	raillerie
mεkuko	raillerie
nyɔmὲ	raillerie
ayìhúngàn	rails
adĭnbèsé	rainette
ɖŏ hwεjijɔ	avoir raison
hwὲ	avoir raison
nù é wù wé zàn bà	raison laquelle
kpò	ralentir marche
wezùn	ramasser
cyán kplé	ramasser
kplé	ramasser
xò kplé	ramasser
àkwέ	ramasser largent
wlă axì	ramasser des choses au marché
amăgà	ramasser des mangues terre
cyăn	ramasser des
bà nakí	ramasser du bois
cyán nŭ	ramasser du bois
nakí	ramasser du bois
wŭn gbadé	ramasser du bois
sà wŭn	ramasser furtivement
sú	ramasser
kplé nùkún	ramasser le
gbὲ ayikún	ramasser les haricots
cyán nùɖúɖú kpεví kpεví	ramasser les miettes
cyán nùɖúɖú winiwíní	ramasser les miettes
agbàn	ramasser ses affaires
cyăn	ramasser à
cyán dĕ	ramasser une à une les cerises palme
dĕzàn	rameau palmier
azàn	rameau épanoui
kplá wă	ramener
lὲ kplá wă	ramener
ɖò	ramener à lunité
wŭn	ramener les jambes vers soi lorsquon est terre
wŭn	ramener vers soi
kùn hŭn	ramer
kùn tɔjihún	ramer
kùn	ramer
vùvó	ramolli
nyĭ	être ramolli
wŭ nú mε	ramollir
ɖà	ramure des arbres
kὲn	rancune
kεn	rancune
nŭhὲnxomὲ	rancune
kεnbiba	le fait chercher rancune
nŭ xwè	ses affaires
nùwlí kánlín	rapace
nùxwlénú	râpe
fεnnyέnlígàn	râpe à
kpákpá	râper langue
adɔví	râper une chambre à
bĭ	être rapide
yă	être rapide
klaxla	rapidement
kléwún	rapidement
kplákplá	rapidement
léwúnléwún	rapidement
nyέwún	très rapidement
yéwún	très rapidement
kplakplà	rapidité
yiya	rapidité
wă	rappeler
flín nŭ mε	rappeler quelque à quelquun
flín sέn mε	rappeler ordre à quelquun
flín sέn mε	rappeler une loi à quelquun
flín sɔgudó	rappeler le passé
flín nŭ	rappeler quelque
mε	être agréable
vìví hă	être agréable
kpà xó dŏ mε	faire faux rapports quelquun
dŏ ajàn mε	faire faux quelquun
mε nŭ	rapporter
mε xó	rapporter
wă	rapporter
àkwέ jì vĭ	rapporter intérêt
hὲn lè wă nú mε	rapporter intérêt
zĕ nŭ wă	rapporter objet
hὲn bɔ	rapprocher
cá	rapprocher deux choses
cá	rapprocher deux personnes
dŏ	rapprocher les extrémités
sὲ	rapprocher
sὲ mε	rapprocher
sὲ dŏ mεɖéé wŭ	rapprocher
ɖà	tête
atánxwlέhá	rasoir
atánxwlέjíví	rasoir
atánxwlέnú	rasoir
xò	être rassasié
kpíkplé	rassemblement
kplékplé	rassemblement
mεkplékplé	rassemblement
tasεkple	rassemblement
cyán kplé	rassembler
kplé	rassembler
kplí	rassembler
sὲ kplé	rassembler
dà ahwàn	rassembler beaucoup monde
dà ahwàn	rassembler des troupes
ɖà	rassembler les cheveux ou plusieurs faisceaux au sommet tête
kpé dŏ	rassembler les deux parties calebasse
kúkú nŭ	rassembler les herbes coupées
gún ɖà	rassembler les tresses des cheveux
kplé dŏ	rassembler
dĕ	être rassis
ayì jὲ dò	être rassuré
nă jiɖe mε	rassurer quelquun
ɖɔfìn	au ventre
gbèjá	des champs
awlĕgbὲ	sorte brousse
ajakaja	ratière
linsinlinsìn	façon rationnelle
blă	rattacher
nyà wlĭ	rattraper
sù	rattraper quelquun
fán asú mε wŭ	ravir
kpácá	ravir
xò	ravir
zìnzín akpà	raviver douleur plaie
sεnwlεὲn	rayé
gbìdí	rayer
xwì dŏ nŭ jĭ	rayer
sέdà	rayonne
ɖì wùn	rayonner
hwεkàn	rayure
tìn tamὲ	pas réagir
jὲ	réaliser
ɖiɖì	réaliser
aɖì	qui sest réalisé
ɖè àkpá	réaliser une promesse
cὲ	réaliser
ɖì	réaliser
tó	rebord
agwὲ	à rebours
jŏ	rebrousser chemin
azàn vì lέ mὲ	récemment
azănmὲfí	récemment
kέnɖíɖé	recensement
mεxixa	recensement
xà mɛ	faire recensement
ɖè kέn	recenser
kέn	recenser
dèkéjé	les réceptacles des noix dans le régime palme
fágbán	réceptacle du fá
yì gbé	à une réception
tè fá	recevoir dernière au culte fâ
tέ fá	recevoir dernière au culte fâ
yĭ fá	recevoir première au culte fâ
sέn fá	recevoir première au fâ au ladolescence
tέ fá	recevoir le génie
bà mε	recevoir quelquun
yĭ mɛ	recevoir quelquun
yĭ kanta	recevoir
xέ mε	recevoir hôte avec tous les honneurs
yĭ	recevoir visiteur
yĭ ɖé	recevoir une récompense
xò ɖìxó	recevoir une
sè	sens général recevoir
găn	réchapper
zò dŏ	réchauffer
xú	réchauffer
xú zò	réchauffer
xú	réchauffer auprès du
xú zò	réchauffer auprès du
xò zò	réchauffer poitrine
ɖò mε gbĕ mὲ	être à quelquun
dŏ àsí nú mε	faire des recherches quelquun
bà mε	rechercher
kéjé	rechercher
bà mεmε mε	rechercher sympathie quelquun
bà mεmε mε wŭ	rechercher sympathie quelquun
nyà gbĕ	rechercher quelquun qui sest échappé
nùhέnnú	récipient
agloví	récipient puiser leau
gannú klobotoò	récipient métallique
sinnukpánù	récipient métallique boire leau
nùjlὲgànnú	récipient métallique mesure
atáɖágbán	récipient faire frire les beignets haricots
sinxwízέn	récipient le filtre
jlὲgánnú	récipient mesurer
sinhεnnú	récipient destiné à contenir leau
kpánù	récipient tôle
yɛhwexixa	récitation prière
xà yɛhwe	réciter des prières
nùjlàjlà	réclame
tò	reclasser
nùkúnyíyá	récolte
aziínkúnkún	récolte darachide
gbadefínfέn	récolte maïs
gbadéyíyá	récolte maïs
agbafínfέn	récolte maïs
ayikúngbígbέ	récolte des haricots
yà jinukún	récolter
gbὲ nùkún	récolter
yà nùkún	récolter des graines
nùkún	récolter des haricots
kùn	récolter des tubercules quon peut ramasser quen creusant
ɖè avɔkàn	récolter du coton
kùn aziín	récolter larachide lorsque terre est
fέn gbadé	récolter le maïs
atàn	récolter le vin palme
zĕ mε dŏ alò mὲ nú mε	recommander
zĕ mɛ dŏ nú mɛ	recommander une personne à quelquun
nă mε	récompenser quelquun
xà	recompter
hwεgbɔdidó	réconciliation
hwεgbɔdudó	réconciliation
ɖă hùn	réconcilier
ɖă hùn nú mε	réconcilier
hwὲ gbò	réconcilier
hwὲ nú mε	réconcilier
dŏ hwὲ nú mε	réconcilier quelquun
lὲ sù	réconcilier quelquun avec le vaudoun après interdit
dŏ hwὲ nú mε	réconcilier quelquun avec autre
dé hwè gbà xă	réconcilier avec quelquun
dŏ hwὲ xá mε	réconcilier avec quelquun
kὲn xá mε	réconcilier avec quelquun
kplá mε hὲn yì	reconduire
kplá mε yì	reconduire
ɖŏ mε	reconduire
nyì mε	reconduire visiteur
dŏ wŭ mὲ nú mε	réconforter quelquun
dŏ wŭ nú mɛ	réconforter quelquun
nùnywέnúmε	envers quelquun
nŭtuwunnúmε	envers quelquun
tuwùn ɖagbè	être reconnaissant
nywέ nú mε	être reconnaissant envers quelquun
tuwùn ɖagbe nú mε	être reconnaissant envers quelquun
tuwùn nŭ mε	être reconnaissant envers quelquun
yĭ	reconnaître délicatesse quelquun
tuwùn mε nŭ	reconnaître quelque
ɖŏ ayì mε jĭ	reconnaître quelquun
tuwùn mε	reconnaître quelquun
yĭ gbè	reconnaître culpabilité
yĭ gbè	reconnaître ses torts
lὲ gbă	reconstruire une maison
gbăn	être recourbé
gbăn	recourber
wă sù mε	avoir recours à quelquun
yi sù	avoir recours à quelquun
găn	recouvrer santé
và	recouvrir
nú mε	recouvrir quelquun pagne
ayihúndá hwεnu	récréation
gbɔjεhwenu	récréation
hwὲ	récréation
ɖŏ	compte
axiwemá	reçu taxe quand au marché
dŏ dò	recueillir
dŏ dò	recueillir réfléchir
jŏ wă gŭdo	reculer
jŏ yì gŭdo	reculer
sὲ yì gŭdò	reculer
yì gŭdò	reculer
gudágwὲ	à reculons
mὲ	récurer puits
xwá	récurer puits
wă dò	redescendre
yì dò	redescendre
kuzŭ	redevance annuelle
kέn	redevance annuelle que le fermier paye au propriétaire
makánɖekpò	rien à redire
văn kàn dŏ nŭ wŭ	deffort quelque
sísí	redoutable
ɖì xεsì	redouter
ɖè kpò	réduire
hὲn kíja	réduire quelque ses éléments
dŏ nú mɛ	réduire quelquun faim
hùzú afín	être réduit cendres
cícέ	réduit frauduleusement
jέn	réellement
ɖŏ	refaire le tas
dŏ	refermer
kú hŭn	réfléchi
dŏ ayì mὲ	réfléchir
kàn ayì	réfléchir
kéjé tamὲ	réfléchir
lìn tamὲ	réfléchir
lìn tamε	réfléchir
sà	agir réfléchir
dŏ nukún mὲ	réfléchir à
lìn tamε dŏ nŭ wŭ	réfléchir à quelque
dŏ ayì dò	réfléchir profondément
xò sù	faire des mouvements réflexes dans le sommeil
nyεɖéé	réflexif
nyεɖéé	réflexive
nùlínlín	réflexion
tamεlinlin	réflexion
fá dŏ mε wŭ	refroidir quelquun
hwlă	réfugier
bὲ	réfugier à
wă sù mε	réfugier auprès quelquun
yi sù	réfugier auprès quelquun
gbìgbέ	refus
nùgbìgbέ	refus
ówŏ	particule exprimant le refus
măwùgbìgbέ	refus dieu
tìn	répondre
zò	mettre marche
gbà gbè alà	découter qui que soit
nú mε	dêtre agréable à quelquun
mεmε mε	compagnie quelquun
mεmε	lamitié
tὲ nùɖé mε	quelque à quelquun
gbè	qui vient dêtre
xwé	daller à maison
kpò ɖò	darrêter
kpò	ralentissant volontairement
nú mε	rendre à quelquun
sí	au
kεn	rancunier
fìn	à dérobée
fìn nŭ	à dérobée
ɖŏ nukún tè	attentivement
tlítlí	avec
jĭ	haut
mε tlítlí	quelquun avec insistance
mɛ	quelquun travers
mε xaàn	quelquun dur
mɛ	quelquun le menaçant
dŏ wŭ nú mε	quelquun lui faisant comprendre quon remarqué ses agissements
nŭ	groupe musique
kpàn	vers
kpàn	à
nùkpέn	dans
wĕ	dans miroir
kpò azàn	avoir régimes
kpò	avoir régimes
kwékwé hwĭn	régime bananes
hwĭn	régime fruits
vìɖókpokántá	régime mariage qui est une atténuée léchange des femmes
dè hwín	régime noix palme
kánkánsùn	régime palme enlevé les amandes
kpokánta	régime spécial mariage
kanmὲ	région
tomὲ	région
hun	désignant région dabomey dans certaines expressions
tamὲ	région tête
tókpá	région loreille
tómὲ	région loreille
nyɔmὲ	région des gencives
alinmὲ	région des
cì	région du
sέlì	région du bassin
hùngómὲ	région du coeur
hè	région du située sous mâchoire
alinkàn	région lombaire
àkwέwémá	registre compte
ɖò hùn mὲ	avoir ses règles
ɖò mε	avoir ses règles
jὲ glegbè	avoir ses règles
jὲ lă	avoir ses règles
jὲ nŭ gŭdò	avoir ses règles
jὲ nùgúdò	avoir ses règles
sùn	avoir ses règles
kpá	avoir ses règles
ɖò gbè jĭ	être règle
ɖò sέn jĭ	être règle
sέlá	les premières règles
sunmεnú	les règles
sέn	règlement
adɔn gεnnyigεnnyi	affaire à régler
dŏ xó mὲ nú mɛ	régler une affaire quelquun
àkwε	régler ses comptes
sú mε	régler une dette à quelquun
jεmaɖì	règles interminables
ɖù	régner
jὲ mε dò	quelquun
jὲ nŭ dò	quelquun
avají	le regroupement des zangbeto après des manifestations
akunvlamὲ	des
jὲ mε jĭ	rejaillir
fέ gbà mε	rejaillir quelquun
nyì	rejeter
nyὲ	rejeter
sè ɖŏ	rejeter
mlă hwὲ	rejeter jugement
sá heelú	rejeter le malheur quelquun
vĭ	rejeter liquide
aɖiví	rejeton arbre
xú jĭ	rejoindre
xwè dŏ mɛ wŭ	rejoindre quelquun
gbà wŭ	réjouir
hùn	réjouir
jàwă	réjouir
jὲ awă	réjouir
awàjíjέ	réjouissance
xomɛhunhun	réjouissance
jŏ dŏ	relâcher
jŏ mε nyì té	relâcher quelquun
ɔ	les propositions relatives
xó xá mε	être avec quelquun
gbà	une fille
busú	orteil relevé
xwè tè	relever
sí tè	relever
dŏ agà	relever
técící	laction relever
glă awà	relever les bras faire limportant
sέkántá	religieux
xà	relire
nukúnɖéjí	remarquable
ɖŏ nukún mε jĭ	remarquer
kέn	remarquer
ɖŏ kέn jĭ	remarquer quelque
ɖŏ kέn nŭ jĭ	remarquer quelque
ɖŏ nukún jĭ	remarquer quelque ou quelquun
jŏ akwέ	rembourser
sú mε	rembourser
atínkὲn	remède comprimés
nùdólánmὲ	toutes sortes remèdes
kpέ	remerciement
kpέdídó	remerciement
kpέdúdó	remerciement
dŏ kpέ nú mε	remercier quelquun
dŏ kú nú mε	remercier quelquun
dŏ kú nú mε ɖŏ nŭ ɖé wŭ	remercier quelquun quelque
jŏ	remettre
jŏ nú mε	remettre
kὲ	remettre
zĕ jŏ nú mɛ	remettre
lìlέ ɖŏ	remettre à tard
zĕ mɛ	remettre à quelquun
xwè tè	remettre debout
lὲ ɖó tè	remettre debout
tò	remettre ordre
nă agbàn nú mε	remettre à quelquun
zò dŏ	remettre le
kὲ mε	remettre une dette à quelquun
zĕ kὲ mε	remettre une dette à quelquun
kplá mε hὲn yì	remmener
kplá mε yì	remmener
hὲn yì	remmener
sὲ dŏ agà	remmener
nă kàn	remonter
nă kàn	remonter une corde
nă kàn gàn	remonter une montre
nà	remonter une montre
nùvìvέ	remords
ayì xò hùn xá mε	avoir du remords
mε	remplacer
jὲ mε tὲn mε	remplacer
tὲn mὲ nú mε	remplacer
mε tὲn mὲ	remplacer
gbágbà	rempli jusquau
gbà kpé	remplir
wŭn	remplir
ɖŏ gàn	remplir loffice crieur
gbĕ	remplir mauvaise herbe
xò zĭn	remplir
bà sìn	remplir deau
yì	remporter
ɖù ahwàn jĭ	remporter guerre
ɖù ahwàn jĭ	remporter victoire
mlàmlá	remuant
nŭ	être remuant
ɖŭ	remuer
hὲn dăn	remuer
xò	remuer
dăn xasaà	remuer
ɖáɖá	remuer et faire tourner tous sens
vùn	remuer pâte avec
dăn	remuer pâte le
jìjé ayikúngban	remuer terre
hùnhún	remuer tête
hùnhún ayì	remuer le coeur
kì jò	remuer les pieds
gbò wundà	remuer les sourcils
yă wŭ	remuer
ayìsájὲ	renard
jὲ	renard
jεxisà	renard
kpé	à
yì kpé mε	à quelquun
kpé nŭ	faire une effrayante ou mauvais augure
nù kpíkpé	deux choses
mεkpíkpé	deux personnes
nù kpíkpé	personne avec
nùkpíkpé	personne avec
mε kpíkpé	entre deux personnes
kúdán	fatale
ɖŭ	rencontrer
kpé	rencontrer
kpé ká	rencontrer quelquun
kpé nŭ	rencontrer fantôme
dŏ gò	rencontrer
kpé gò	rencontrer
xò gò	rencontrer
kpé xó xá súnnù	avoir rendez
kpé xó xá súnnù	vous avec homme
kpé xó xá	avoir rendez
kpé xó xá	vous avec une femme
jŏ	rendre
jìjó	rendre
jŏ nú mε	rendre à quelquun
zĕ jŏ nú mɛ	rendre à quelquun
gὲdέ	rendre compliqué
ɖŏ gbè nú	rendre compte à quelquun
àkwε	rendre des comptes
blŏ ní	rendre
ɖŏ	rendre
dŏ xò	rendre enceinte
dŏ kú nú mε	rendre grâces à
jŏ avalú mε	rendre hommage
xò gbè	rendre hommage
jŏ avalú nú mε	rendre hommage à quelquun
nyì avalú mε	rendre hommage à quelquun
mɛ	rendre hommage à quelquun
lŭ	rendre
dŏ hwejijɔ nú mε	rendre à quelquun
gbò hwὲ nú mε	rendre
ɖŏ nú mε	rendre malade
hὲn	rendre
dŏ mε	rendre quelquun malade
dŏ xò nú mε	rendre quelquune enceinte
dŏ mε	rendre à quelquun
gὲdέ	rendre tortueux
blŭ	rendre
nà	rendre culte au vaudoun fécondité
xέ nà	rendre culte aux nà leur offrant à
hùn bŏ	rendre inefficace
bà	rendre
nŭ dŏ mε	rendre à quelquun
jŏ mεɖéé nú mε	rendre à quelquun
jŏ amĭsa nú mε	rendre chez celui qui commandé une
nŭ mɛ wŭ	rendre coupable
ɖidó	rendre dans
ɖù găn	rendre maître
gbăta	qui tête renflée
blŏ ní syέn	renforcer
nă syέnsyέn	renforcer
kpíɖíkpíɖí	idée renforcement
alɔgígó	renfort
alɔgúgó	renfort
nylă nukúnmὲ	avoir une renfrognée
nukúnmε	renfrogner
nylá nukún mὲ	renfrogner
zyăn	rengorger
mεgbigbέ	reniement
mεmεgbέmὲ	le fait renier familiarité avec quelquun
mε	renier quelquun
mεmε mε	renier quelquun
sὲ misin dŏ	renifler
alagá	renseignement
wìnní	renseignement le quelquun
kpì tàn	renseigner avec les faits vécus
agbotòhăyàhăyà	à
flíjὲ	renversement
flí jὲ	renverser
flí xwè	renverser
gbà dεὲn	renverser séparpillant
hùzú xwè	renverser contre terre
fán	renverser
flí gbà	renverser
gbà	renverser
hùzú	renverser
mù zìn dŏ ayĭ	renverser
mù zìn dέ	renverser
vìvá	renverser
xwè	renverser
zìn	renverser
zĭn dŏ ayĭ	renverser
gbà sìn	renverser leau
mù	renverser une
sέ dó	renvoyer
nyà	renvoyer
nyà sέ dó	renvoyer
nyì	renvoyer
tún	renvoyer fumée
tún	renvoyer fumée ou les narines
le nú nŭ sέ dó	renvoyer quelque
vuvɔjɔ	réorganisation
fúnfún kpé	répandre
fúnfún kpè	répandre
gbà	répandre
gbà dŏ	répandre
gbà nyì	répandre
hìnhέn	répandre
nyì	répandre
sisa	répandre
hlὲnhlέn	répandre
dŏ vὲ	répandre farine devant le où réside vaudoun
dŏ akutù	répandre farine le legba
gbà sìn	répandre leau
gbà dεndὲn	répandre fines gouttelettes
gbà fún	répandre les plumes
gbà dŏ ayĭ	répandre terre
gbà gbĕ	répandre
gbà kpé	répandre
tún flá	répandre
vùn gbà	répandre
vùn kpé	répandre
sà vò nú mε	répandre doléances
gbà dεnɖὲn	répandre fines gouttelettes
hànnyá	répandre morceaux
sà kpé ayìkúngbàn	être répandu terre
dŏ	réparation
dŏ	faire réparation
blŏ ɖŏ	réparer
jlă	réparer
jlă ɖŏ	réparer
lὲ ɖó tè	réparer
afɔkpà	réparer des chaussures
yì	repartir
gbà	faire le repas qui clôt une cérémonie vaudoun
kantamímέ	le repas eucharistique
hunmεxwlέ	repas qui clôt une cérémonie
lì	du
xwísé	une fois farine dans le
hwεvέnúmε	repentir
nùvìvέ	repentir
nùvὲnúmε	repentir
hwὲ vέ nú mε	repentir
hankpá	répétition
kán tùn	repiquer
wŭn	les jambes
yĭ gbè	répondre
yĭ gbè nú mɛ	répondre
yì gbé	répondre à une
zunta nyi gă	répondre au hasard
cyá	répondre avec appel
kpé nukún wŭ	répondre
sɔ	répondre quon entendu
zunta nyi gă	répondre réfléchir
gbeyiyí	réponse
wĕ	réponse à une difficulté
flíjὲ	réponse contraire
gbeta	réponse fixe
flíjὲ	réponse opposée
gbɔjέ	repos
gbigbɔjέ	repos
gbugbɔjέ	repos
ayìmímlɔ	repos
ɔ	à voix avant le discours
wŭ	repousser
sísέ	repousser
tún	repousser
tún mε	repousser quelquun
wli	reprendre
yĭ nŭ sín mɛ así	reprendre que lon donné
yĭ sín mε así	reprendre que lon donné
yĭ hàn	reprendre le
dŏ ayì dò	reprendre ses esprits
ɖŏ tè	représenter quelquun
mε tὲn mὲ	représenter quelquun
mε sín ɖŏ té	représenter quelquun
fεnfɔnúmε	réprimande
nŭ nú mε	faire des reproches à quelquun
mεɖedó	reproches constants et justifiés
nŭ dŏ nŭ wŭ nú mε	reprocher quelque à quelquun
kὲ dŏ nŭ wŭ nú mε	reprocher quelque à quelquun
tɔló	africain appelé couramment caïman ou
lŏ	africain appelé couramment caïman ou
asigbibé	répudiation
gbέ asì	répudier femme
asì	répudier femme
hὲn	répugner
wŭ	répugner
kpasìn	réserve
ɖò ayĭ	réserver
hὲn ɖáyĭ	réserver
hὲn ɖŏ tè	réserver
gbò hwlă	réserver une soi
mε ɖŏ tè nú mε	réserver une personne une autre
cí	résider
kpè	résidu lhuile
amijá	résidu lhuile palme
jă	résidu pâte riz etc qui reste collé au fond récipient
alolyán	résidu
alolyán	après du bois
àliyán	résidu ou bois écrasé
dèlyán	résidu filamenteux partie charnue qui enveloppe lamande palme lorsquon lhuile
sundidε	résistance
glŏ	idée résistance
syέnsyέn	résistant
dὲ	être résistant
lŏ	être résistant
syέn	être résistant
syέn dà	être résistant
dὲ	résister
dὲ sún	résister
syέn	résister
tùn tè	résister
jì	résister aux intempéries
ɖì	résonner
ɖì gbè	résonner
flán hŭn	faire résonner le annoncer que lon va à jouer
jὲ gbè	résonner
xó gbò	résoudre une affaire
ɖè nú mε	jeter terre le et les épaules le présent
sísí	respecté
gbà acὲ	pas
nyì sέn	loi
sí mε	quelquun
gbɔjέ	respirer
xíí	respirer comme asthmatique
agbanɖotanánɔ	responsable
ɖò mὲ	être responsable
mεnugán	responsable groupe
gbò mεɖé fán	ressaisir
ɖì	ressembler
ɖiɖì	ressembler
ɖɔhùn	ressembler à
cí nùɖé	ressembler à quelque
ɖì mε	ressembler à quelquun
kὲn	ressentiment
xomɛsìn	ressentiment
kplé yŏ	avoir les cuisses très resserrées
kplí yŏ	avoir les cuisses très resserrées
blă jí	resserrer
blă xó mε wŭ	resserrer
dà	avoir ressort
jlă ɖŏ	restaurer
lὲ ɖó tè	restaurer
kpukpò	reste
nù kpúkpò	reste
kpikpò	reste
kpó lέ kpán	avec les
atán fín	avec les bave nuit
kpé kpò	être reste
kpò	être reste
ɖukpò	reste nourriture
kánkpò	reste pâte
tέ	à cours dexplication
tέ	à darguments
jὲ wĕ	à découvert
cí vò	à lécart
xò yonu zò	longtemps
xú hwè	au
xú	au
hùn jεὲ	bée
xwè	calme
cí gŭdò	derrière
ɖò kὲn xá mε	état dinimitié avec quelquun
wunzὲn	éveillé
xò zăn	éveillé
gbejí	fidèle
cí	inerte
kpò	invendu
nú mε	quelquun
cuù	pensif
cí cúɖúɖú	bouger
cí tiì	mouvement
àcéjí	le qui
nŭ jí	quelque
tè	toute nuit dormir
cí cúɖúɖú	tranquille
xwè	tranquille
jŏ	restituer
jŏ nú mε	restituer
zĕ jŏ nú mɛ	restituer
buwùntú	restreindre
jă jĭ	résumer
lέ	résurrection des hommes
klístu	résurrection du christ
fún sé	retailler une meule
fún sé	retailler une pierre à moudre
gàn	être
hwenu	être
ɖè kpò	retenir
ɖŏ kέn jĭ	retenir
hὲn	retenir
hὲn ɖŏ tè	retenir
hὲn mε ɖŏ tè	retenir
hὲn nŭ dŏ tamὲ	retenir
hὲn nŭ tamὲ	retenir
kέn	retenir
cí mε jĭ	retenir quelquun
avĭ nú mεɖé	retenir ses larmes
ɖò tè	retenir
fán nŭ	retenir à quelque
sìn	leau quon fait bouillir
gbà dεnɖὲn	foule
jὲ mε jĭ	retomber quelquun
xwè tè	retomber ses pieds
yì	retourner
yì gŭdò	retourner arrière
flí	retourner le récipient faire sortir pâte
hùzú nŭ	retourner une
kpàn	retourner
gŭdò	retourner arrière
ɖè	retrancher
ɖè sín	retrancher
gbò	retrancher une partie quelque
sóbwé	rétréci
sóbwé	être rétréci
wŭn	rétrécir
sὲ dŏ agà	retrousser
dŏ mε	retrousser le nez signe moquerie
ɖŏ ayì tè	retrouver froid
xlohŭn	retrouver seul
kplé ɖò	être réuni
yì kplé jí	à une réunion
axijijε	réunion des au marché
nùxíxó	réunion où lon joue du
nùxúxó	réunion où lon joue du
kpíkplé	réunion
kplé	réunion
kplékplé	réunion
mε kplékplé	réunion
kplé	réunir
sὲ kplé	réunir
wă kplé	réunir
kplé	réunir traiter quelque
wŭ	être réussi
kpà mε	réussi du
cὲ	réussir
kpà mε	réussir
kpò	pas réussir
gbà mε	réussir à avoir
gbà mε	réussir à mettre quelquun
dĭn	réussir à concours
tέn	réussir dans quon entrepris
dĭn	réussir
kú	faire rêve
aɖì	rêve prémonitoire
aɖì	rêve qui sest réalisé
gàn	réveil
fín	létat où lon trouve le au réveil
dŏ mε wŭ	réveiller quelquun bonne heure
dŏ vέ nú mε	réveiller quelquun plein sommeil
wìnnyá	réveiller
hawùn	réveiller sursaut
nyì	réveiller sursaut
nyĭ	réveiller sursaut
ɖè nŭ xlέ mε	révéler
ɖè	révéler
gbă nŭ	pas révéler une affaire au jour
nŭ nyanya dŏ mε wŭ	révéler les défauts
gunnukó	sorte très qui devient subitement très
sà	revendre
kpà tέ	revendre au détail
flí sà	revendre au même prix quon acheté
wă	revenir
dĕ	revenir à
bà mε kpò	revenir bredouille
sín	revenir
jὲ alì jĭ	revenir le chemin
tέkpíkpá	revente au détail avec bénéfice exagéré
sín	être revenu
kú	rêver
dŏ dò nú mε	faire des révérences devant quelquun baisant terre
dŏ dò	faire une révérence tête
alɔgúdo	le
é sù hweɖénu	au revoir
dŏ yì bó wá nú mε	au revoir à quelquun
kú	être égoïsme révoltant
amaxuxò	révolte
gŭ	révolter
jὲ hetè	révolter
dŏ mε jĭ	révolter contre quelquun
gŭ dŏ mε jĭ	révolter contre quelquun
hùzùhúzú	révolution au bénin
akpomεtú	révolver
awukplεmεtú	révolver
awumεtú	révolver
sunmεwemá	mensuelle
flé nukún	avoir les yeux révulsés
xúɖúxúɖwí	rhumatisme osseux
kpέn	rhume poitrine
kò	ricaner
ɖŏ	être riche
kplé dɔkùn	des richesses
dὲ	être ridé
kanxisí	fibre bambou
fó	ridiculiser quelquun
nŭ ɖokpó ă	rien
nù tí ă	rien
nùɖé ă	rien
nùɖéwúɖà	rien
xísá	rincer vaisselle
hŭ mὲ	rincer
awajέdíngàn	ripaille
kò nŭ	rire
nùkúkó	rire
nùkónúkwé	celui qui le temps
hahahà	façon rire
tó	faire rire
nùkúkó	le fait rire
kὲ awè	rire à et à travers des motifs futiles
kò nŭ hahahà	rire aux éclats
kò nŭ yàvĭ	rire aux larmes
wlă mε kò	rire beaucoup quelquun
kò nŭ xíxíxí	rire façon étouffée
kò nŭ xéxé	rire façon sarcastique
kò nŭ xéxéxé	rire façon sarcastique
kò nŭ	rire quelque
kò mε	rire quelquun
ɖɔkwè	risée
tá wá	courir le
táá	courir le
yɛsù	des cérémonies funèbres
jeɖiɖa	du
yɛsù	le culte des esprits
asúxíxá	une femme ladultère été découvert
yɛsù	que lon accomplir vivre paix
lì zà xá mɛ	rivaliser
tɔzan	partie éloignée
tɔwúnù	qui habite les villages lacustres
tɔfinnù	du leau ou lacustre
hlàn	rivière
dùn sìn	rivière
avă	sorte rivière
dŏ	robuste
xú	être robuste
dŏ nŭ	rôder
cέ	rogner
kpà	rogner
ɖù	rogner discrètement nourriture que lon partager
sέn hwὲn nú mε	rogner le du voisin qui laboure avec soi
gawú	du temps des rois dabomey
gezò	huitième dabomey
saxé	le dabomey
agblagójì	le
dadá	le glèlè
akábá	nom dabomey
àdándózàn	nom qui régna à abomey
agajá	dabomey à
dogbagli	dalada
dogbagligεnu	dalada
atínsú	des arbres
fέn	rompre
gbà	rompre
tlέn	rompre
kíjá	rompre déchirant
tún	rompre le jeûne
jă	rompre nimporte
kpɔfὲn	sorte ronces les épines sont très longues
kláxlá	qui fait le
tóbwé	et diamètre
gblóbótwé	et très
xwalunlùn	ronflement
lùn xwà	ronfler
ɖù	ronger
nyĭ	ronger
àcú	des champs
àcú glὲzĭn	des champs
glὲnzĭn	des champs qui que nuit
mimε	rôti
sisɔ	le fait rôtir
hìzá	rôtir dans récipient avec lhuile et
gbà vă	faire
nyì akpá	faire
tὲ	faire
avɔkangbεkεkέ	rouet traditionnel
vivo nyaà	éclatant
vɔvɔ nyεὲ	foncé
kponyinyi	rougeole
dohunnú	avoir rougeole
hù azwì	avoir rougeole
jὲ azwì	avoir rougeole
nyì kpò	avoir rougeole
jὲ hwὲ	rouiller
jὲ kò	rouiller
hwεjijε	le fait quun fer
klá	rouler
dŏ	faire rouler véhicule
blĭ bŭ	rouler
flí zàn	rouler une natte
blĭ gbă	rouler terre
kútómὲ	le royaume des ombres
dŏ	avec fureur
dŏ	brutalement
wlă	des marchandises
wlă	nourriture
dŏ gbè	rugir
aglìn	ruines maison
hwĭn	quelquun
xwé	totalement une maison
nutùntùn	du jeûne
mɛ zinzin	rusé
mεbíbí	rusé
mεsísέ	rusé
cá	être rusé
dĕ	être rusé
klá	être rusé
sέ	être rusé
zìn	être rusé
gὲdέ xá mε	ruser avec quelquun
sè gàn	avoir le sens du rythme
gblà	rythme propre au vaudoun xebyoso
akatawuntò	rythme
kpaca	rythme funèbre
adi	variété rythme
sanmyá	couleur roséemauve
nyὲkέn	mer
vεsísà	qui est à terre
yɔsà	qui recouvre le tombeau
nyὲkέntέnmὲ	sablière
hwĭ	sabre et pointu
adlà dεnkpè	sabre guerre
akpólà	sabre dexécution
gló	le à gló
vatέ	devin
kpέtέví	tissu que les femmes
glŏ	à
aglo	décolier
cakì	chanvre
aglo	général
tέkpò	peau dantilope
avò	raphia
kέnví	fait avec des joncs
gbayikún ɖokpó	kg maïs
gbà	saccager
gidigidì	saccager
kpɔlí	contenant principalement le
azɔkplà	le tabac et dautres accessoires
akpò	étoffe
saklamέtù	sacrement
yɛsinsɛn	sacrement
wŭntungbɛnà	sacrement lordre
yɛhweni lé	sacrement lordre
kέ	faire
sú kúlí	faire qui à écarter
adlaɖenú	au fà
adlà	offert au fà forêt
adlaɖiɖè	écarter malheur initié au
nàxíxέ	sacrifices ou offrandes aux nà
tanú	sorte le bonheur soi
nŭ dŏ sà nà nú	sacrifier quelque à
suɖuɖu	sacrilège
ɖù sù	commettre sacrilège
ɖu sù nú măwŭ	commettre sacrilège
ɖù sù nú vodún	commettre sacrilège contre vaudoun
gbà hùn	commettre sacrilège contre vaudoun
hungbigba	sacrilège à vodúnsì
ɖŏ mεxó ayì	être
dotó dotó dotó	femme diplômée
mεxóyí	sagesse
mεxóyíɖíɖó	sagesse
nùnywέ	sagesse
ɖì hùn	saigner
dŏ hùn	saigner
sò wìnnyà	saigner du nez
nyὲ hùn	saigner lanus
yɛhwe	paul
yɛhwenyinyí	sainteté
hὲn	saisir
sà	saisir
xò	saisir
sísà	saisir
gblă tó	pas saisir
ayì wŭ	saisir sy
ayì ɖó é wŭ	saisir sy
wlĭ ɖàyi	saisir dans
wlĭ ɖàyi	saisir coeur
fàn	saisir solidement
fàn asú mε wŭ	saisir solidement
fàn asú mε wŭ	saisir violemment quelquun lui arracher quil possède
akpakpà	saisissement
xwejí hwenu	au temps grande saison des pluies
xwejí	au temps grande saison des pluies
sinmὲ	au temps grande saison des pluies
jì hwènu	au temps grande saison des pluies
akúmὲ	dans saison sèche
aluún	dans saison sèche
aluúnmὲ	époque grande saison sèche
aluúnsùn	époque grande saison sèche
fomὲ	saison sèche
mὲ	saison des pluies
ayì vodún	sakpatà
sagbatà	sakpatà
yovómà	salade
sunmεkwέ	salaire mensuel
sunzanfífókwé	salaire mensuel
sunzanfúfókwέ	salaire mensuel
sunzankwέ	salaire mensuel
gbò adŭn	être
kújì	être
kwíjì	être
dŏ jὲ mὲ	saler
dŏ jὲ làn	saler viande
àfέn	saleté
àfέnnú	saleté
ɖìxó	saleté
fέn	saleté
nùkwíjì	saleté
wà afέnnú	faire une saleté
jεgbà	salière
jεgbàn	salière
jεgò	salière
jεkà	salière
agbanutín	salière toiture
jεgbají	à
và nuɖé dó mε wŭ	salir
xò	salir matériellement et moralement
hὲn nùɖé kwíjì	salir quelque
và babà dŏ mε wŭ	salir quelquun
bléwún	salir
ɖă	salir au quelque
fàn adùn	salir avec boue
xò adùn	salir avec boue
fàn	salir avec terre
fàn mĭ	salir avec des excréments
và babà dŏ mε wŭ	salir boue
xò babà	salir boue
atàn	salive
dὲ	salive
atàn fín fín	salive et intactes
agbasà	à
nùɖúxɔmὲ	à
akabaxɔsà	dattente au palais du
akpablàxɔmὲ	pansement
agbasà	repos
fàgbàsà	où lon consulte le fà
tokplégbàsà	publique
ajalalasà	variété
ajalasà	variété
ajalalà	avec nombreuses portes
ajlalà	avec nombreuses portes
dŏ gbè	saluer
nŭ dŏ mε	saluer quelquun
dŏ gbè sùn	saluer nouvelle
dŏgbè mε	saluer quelquun
dŏ gbè mε nú mε	saluer quelquun au nom quelquun
mì nú mε	saluer quelquun
gbedidó	salut
gbedómε	salut
gbedudó	salut
gìngàn	salut
hwìnhwlέn	salut
hwlὲngàn	salut
hwlὲnhwlέn	salut
doo	salut que lon adresse aux personnes qui reviennent
ayihún gidigidì	jeu
akɔnyinyi	jeu cartes avec enjeu
xwenúmɛ	une des formes du jeu dajì
sabàɖú	samedi
sabàɖúzàn	samedi
sàtide	samedi
sàtidegbè	samedi
sàvódó	samedi
sàvódún	samedi
sàvódúngbè	samedi
síbígbè	samedi
mε húzú yεhwè	quelquun
hunnuwàtὲn	sanctuaire
malεfɔkpà	sandale
sàlúbatà	sandale
hŭn	organe du et principe
hunɖiɖa	cuit préparé comme mets
hunlanfàn	mélangé avec leau
gbèglúzà	espèce sanglier
jiji	sangloter
afɔmasὲ	déplacer
afɔmasὲmasὲ	déplacer
kyεkyε	soin
vazavazà	soin
gblowunkan	sous
gblowunkan	entendu
ɖò yìyà jí	tarder
malinmàlín	tarder
mεhɔnwùn	vergogne
wùɖìɖí	être défaut
jŏ kàn	être
dà	être
tlí jì	être peur
ayì jὲ dò	être souci
sà lelè	être soutien
sà xwexwe	être soutien
hù winnyà gbò	être vergogne
kɔmalέ	arrière
kplululù	arrêt
tè	arrêt
temanɔmanɔ	arrêt
góó	arrêt
cέxwlὲ	assaisonnement
faà	aucun problème
mawayὲ	aucune tromper
ɖò gbawunjò mὲ	avoir à rendre compte
kléjé	avoir rien
masεtὲn	bouger
hòhò	cesse
hohohò	cesse
magbokɔ	cesse
hehehè	cesse
màmàmà	cheveux
fεε	contrainte
cúɖúɖú	férir
woyaà	crainte
blŭjù	décorticage les noix palme
blɔ	défaut corporel
blɔmàɖòwú	défaut
blɔmàɖòwú	défaut spirituel
blŭ ɖà	dessus dessous
jεjεjὲ	faire
zàà	faute
xlówún	frotter à droite à
masàtέn	grande
cέkíí	histoire
fεε	inquiétude
jămijò	maîtrise
numaɖú	et boire
sinmanu	et boire
ɖóɖó	mélange
nyε mεvò	moi
blŭjù	mouture
cayaà	ordre
makεnu	parler
fatàa	le
fatàa	lentrée
cúɖúɖú	bouger
cúɖúɖú	parler
màmàmà	poils
fεε	problème
mεhɔnwùn	pudeur
kɔmalέ	reculer
malέkɔ	reculer
malintamὲ	réfléchir
makànɖekpò	reproche
hunnyahunnyà	retenue
lέέ	rien
nùtímàwà	rien faire
bεwunjú	bonne santé
ɖò ɖagbè	être bonne santé
wŭ	être bonne santé
ɖagbe	être bonne santé
ɖagbè	être bonne santé
nú mε	être bonne santé
nùxwíxwà	sarclage
glè	quand terre est
ahwĕ	fraîche
ahwε mú	fraîche
gannumεhwéví	sardines boîte
dŏ	satisfaire
jὲ mε nú mε	satisfaire quelquun
kpé nú mε	satisfaire quelquun
ahàan	exprime satisfaite
xò wuntà	pas être satisfait
fùn kpεtὲ	faire avec du et farine maïs
fùn hùn	faire avec du et farine maïs
nùsúnnú fín	veille réchauffée
gusí nùsúnnú	au gùsi
nùsúnnú	brûlée
mă nùsúnnú	légumes
nεnúsìn	nεnú
hweví nùsúnnú	poisson
làn nùsúnnú	viande
wàn	faite avec des haricots grillés et moulus
dεnú	filante
nùsúnnú	gluante
vatakpà	légère beaucoup condiments
nùsúnnú	que les européens appellent souvent caloulou
kpaɖà	quelconque défaut certains condiments
jεmεsìn	légumes
hlŏhlŏ	variété jumeaux défunts
agbò	faire le
nyì agbò	faire le périlleux
nyì ajagàn	faire le périlleux
ajagàn	périlleux
kàn	sauter à corde
ɖì wùn	sauter aux yeux
ɖì vò	sauter branche branche
ɖè vò	sauter branche branche
dŏ asà	sauter dessus quelque
yì jĭ	sauter quelque
jlέgbò	sautiller
gbèmέnu	sauvage
găn	être sauvé
gìngàn	le fait dêtre sauvé
ɖeɖὲ	sauver
găn	sauver
ɖè hwὲn mε	sauver quelquun
mε	sauver quelquun
yì	sauver
kpà	sauver
fànjí	savane
sè amà	être
tuwùn nŭ	être
nùnywέ	savoir
nywέ	savoir
nywέví	celui qui sait
kú gàn	pas savoir danser
nylă wè ɖŭ	pas savoir danser
nylàn wè ɖŭ	pas savoir danser
dăn dò nú nùɖé	rien savoir quelque
nywέ	savoir à lavance
sè gàn	savoir danser
wè ɖŭ	savoir danser
hὲn nŭ xomὲ	savoir garder
jĭ	savoir garder
tuwùn dŏ mὲ	savoir coeur
hὲn nŭ xomὲ	savoir tenir langue
jĭ	savoir tenir langue
àɖĭkɔtɔ	savon
kɔtɔ	savon couleur grise
dŏ aɖì	savonner le
sà aɖì dŏ	savonner le
lὲ aɖì	savonner
aɖĭ	savonnette
yovóɖí	savonnette dimportation
vìví	être savoureux
zegé miblímíblí	scarabée coprophage
zegé	scarabée général
gbò hwὲ	faire des scarifications
jă atín	faire des scarifications
jă atín	faire des scarifications simmuniser contre quelque
gbò kisí	faire une
atínjíjà	dimmunisation traditionnelle
sakpatàhwε	scarifications propres aux sakpatàsì
gesí	sceau
tlέ	sceller
sà	scie
kansà	scie à chantourner
kansàà	scie à chantourner
kansìn	scie à chantourner
zὲ atín	scier
nyέnyέnyέ	scintiller
kέn nyέnyέnyέ	scintiller
ahɔnmεlalà	scolopendre
hɔnmεlalà	scolopendre
awolomí	scories
hɔnkékélé	espèce
kéklé	espèce
hɔnkléklé	espèce
agasà	très
tlítlí	scruter
gbèjé	scruter attentivement quelque
kpà awĭnyà	sculpter
klubà	seau
dotɔgannú	seau employé puiser
tɔkà	seau employé puiser
akúmὲ	au temps
mὲ	sécher
mimε	mettre à sécher
xyà	faire sécher
xú	sécher au
xú zò	sécher au
xíyà làn	sécher viande
linsinmὲ	secondaire
gbὲɖέ	secouer
hùnhún	secouer
alɔmimi	secouer
mimi	secouer
jò linfín	secouer ligname ou du pilés ramener à les morceaux quil faudra à nouveau
xúxú gbèhàn	secouer des touffes dherbes faire tomber terre
mì	secouer après avoir touché quelque chaud
mì	secouer après avoir touché quelque
xò	secouer pâte quelle adopte du récipient
xúxú afúntúntún	secouer poussière
xúxú	secouer tête
dŏ mε	secourir
alɔdómε	secours
alɔgígó	secours
alɔgúgó	secours
càxóxooó ɖíè	au secours au voleur
kpànú	affaire secrète
donu	concernant les talismans et pharmacopée
hùn xó	du vaudoun
hùnxó	du vaudoun
hwlàhwlà	secrètement
hwlăn	sécréter liquide
sɔnu	secteur du marché réservé à telle ou telle denrée
lansɔji	secteur réservé à viande
lansɔnu	secteur réservé à viande
nakísɔnu	secteur réservé au bois chauffage
avosɔji	secteur réservé aux tissus
mε	séduire
gblĕ	séduire
hὲn mε gblé	séduire
gblĕ mε	séduire quelquun
lŭ mε	séduire quelquun
mε	être séduisant
nέnέ	sein
hwlăn	avoir des seins naissants
gogoɖogò	seins formés et
cí	séjourner
jὲ	sel
jɛ xayà	du sel réduit poudre
jεkέn	sel
cyàncyàn	sélectionné
adà gblă mε	avoir besoin daller à selle
nyὲ hùn	avoir des selles sanguinolentes
zínkpó	selle vélo
vodúngbe gblamὲ	semaine
ɖì	être à
ɖɔhùn	à
jὲ nyĭ	avoir nom
cí ɖì	sembler
ɖì	sembler
afɔkpàkpà	semelle
nùkún	général
dŏ jinukún	semer
dŏ nùkún	semer
dŏ aziín	semer larachide
dŏ avajà nŭ mὲ	semer du désordre
fún	semer du désordre
fúnfún nùkún	semer du à volée
dŏ hwinyahwinya mὲ	semer zizanie
hὲn dăn	semer lagitation
fúnfún nùkùn	semer le à volée
dŏ hwinyahwinya mὲ	semer le
agunkpàmὲ	semeur discorde semeur troubles
yɛhwenɔ gleta	séminaire
hŭ nùkwín	faire des
và nùkwín	faire des
và nŭ	faire
tínmὲ	sens
blŭ ɖà	être sens dessus dessous
nyiì wiiìn	exprime une bienêtre
yaà	qui fait éprouver une douleur et fugace
hŭn	du akaba
aliswέέn	sentier
yɛhwín	sentier que tracent les animaux dans brousse
nùkànmέlì	sentier brousse
ɖè wăn	sentir
lùn wăn	sentir
sè wăn	sentir
wùyàmɛ	le fait sentir léger
hwìnhwέn	qui
yĭ	sentir honoré
wăn	sentir
jὲ mε	seoir à quelquun
klàn	séparation
klànklàn	séparation
xɔgbigbo	séparation
xɔgbugbo	séparation
ɖò vò	être séparé
vokàn vokàn	séparément
ɖă	séparer
ɖè ɖŏ vò	séparer
gbò	séparer
kàn mε ɖó vò	séparer
klàn	séparer
kíjà	séparer brutalement
ɖè	séparer morceaux
ɖè	séparer quartiers
ɖă hùn nú mε	séparer deux combattants
ɖă mε	séparer deux personnes
cyàn dèkín	séparer les amandes palme leur brisée
vuvomumɔ	sérénité
fànnàfànnà	sérieux
xwlé aɖĭ	faire
xwlĕ măwŭ nyĭ	faire
tɔdàn	aquatique
danmifún	bananier
xlibó	cracheur
domεdàn	très
domεdàn	des revenants
aɖiɖàn	très venimeux
lὲnklέnsέn	très venimeux
amanɔnú jakpatà	trigonocéphale
jakpatà	trigonocéphale
dangbé	vaudoun
lyὲnklέnsέn	qui grimpe aux arbres
danmifún	tirant le jaune
xàsàxàsà	enroulé lui
xàsàxàsà	même
fὲn	serre
tέnwùn	serré
kpítí	être serré
jànjànjàn	très serré
kpítíkpítí	très serré
sìn kàn dŏ	serrer
xà	serrer
sὲ dŏ mεɖé wŭ	serrer
blă	serrer ceinture
tablanú	serretête
sìn	serrer autour des
sìn dó alìn	serrer autour des
dó mὲ	serrer à félicitations
nă mε	serrer quelquun
hὲn flέὲn	serrer le frein
xà mɛ	serrer quelquun
tablà tabladukwí	serretête
gŏ	qui serre
sεlí	serrure porte
deví	servante
wà nú mɛ	être au quelquun
nú mɛ	être au quelquun
sὲn	servir
wlŏ nŭ ɖù	servir abusivement des biens nécessaires à autrui
dŏ wà nà	servir à
wà nà	servir à
sè gbè nú mε	servir dinterprète à
sὲn	servir le
deví súnnù	serviteur
yì vĭ	enfant comme serviteur
alihέnnú	seuil
hwὲ	seuil
kpekàn	seuil
kpokàn	seuil
hɔnlihέnnú	au seuil
hɔnlinu	au seuil
ɖóɖó	seul
bàvú	seul
gblĭgbὲ	seul
hawùn	seul
hawùnhawùn	seul
hwεnwùn	seul
kpétè	seul
mawùn	seul
mlàwún	seul
mlεwún	seul
tówún	seul
vawùn	seul
gbuwùn	seul
lòlwé	être seul
ɖokpó	seul
ɖokpógéé	seul
géé	seul
nŭ ɖokpógéé	une seule
ɖokpó	une seule fois
ɖokpógéé	une seule fois
xlohŭn	seule
jàn	seulement
jέn	seulement
kpowùn	seulement
kέɖέ	seulement
atàn	sève du palmier
lokócέ	sève du roko
hùn zò	être sévère
syέn	être sévère
hunnylanylà	sévérité
jijɔsyέnsyέn	sévérité
ɖè nú vĭ	sevrer enfant
nɔ	dans le sexe mère
nɔwe	dans le sexe mère
anagantà	sexe femme
ɖŏ	sexe masculin
mama	sexe
vatε	sorte
vatε	sexe rudimentaire
blŏ vayúù	jeune garçon qui des rapports sexuels avec une jeune fille et versa
yì súnnù	avoir des rapports sexuels avec homme
bà sìn nyì àyĭ	avoir des rapports sexuels avec homme
yì	avoir des rapports sexuels avec une femme
bà nŭ ɖù	avoir des rapports sexuels avec une femme
kpàn	avoir des rapports sexuels avec une femme
wà	avoir des relations sexuelles
wà yŏ	avoir des relations sexuelles
bà mε	avoir des relations sexuelles avec une femme mariée
bà	avoir des relations sexuelles avec une femme mariée
gbă nú mε	avoir sexuel avec une jeune fille vierge
jὲ xà mε	avoir sexuel avec quelquun
kpé xà mε	avoir sexuel avec quelquun
wà	faire lacte sexuel
cí ɖɔhùn	comme
vέ	seulement
xwe kanweké	siècle
azinkpo kíjέkíjέ	siège branlant
ayì	siège du et pensée
jăn	siège fait avec des branches palmier raphia
ée	sien
kùn kpetè	siffler
kwínkwín	siffler
kún kwín	siffler avec
kwín	siffler avec
kún flè	siffler avec métal
kún sùn nú vĭ	siffler cérémonie sunkúnkún
kún sùn	siffler cérémonie sunkúnkún
nùjìjlέ	signe
nùjlὲjlέ	signe
mì nú mε	faire signe à quelquun
gbò wundà nú mɛ	faire signe à quelquun soulevant les sourcils
mì nú	faire signe à
zĕ nú mε	faire signe à
mì nukún	faire signe des yeux
wùn	faire signe des yeux à quelquun
mì nukún nú mε	faire signe des yeux à quelquun
mì wùn nú mε	faire signe des yeux à quelquun
ɖŏ wŭntùn	faire signe
gbò wundà	faire signe et abaissant les sourcils oui
wŭntùn aklúzu	le signe croix
nŭsìnnŭ	signe mauvais augure
dutitὲ	signe du fà
dù	signe du fà
fàdù	signe du fà
gbădù	signe du fà le possesseur est très craint
losò	signe du génie
duví	signe
duví	enfant dans du fà
dutitὲ	signe
dutitὲ	mère dans du fà
dŏ wĕmà mὲ	papier
tὲ wĕmà mὲ	papier
dŏ wĕmà	une lettre
makεnu	silencieusement
fέ hwὲn	faire deuxième partie
kàn hwὲn	faire première partie du
fε hwὲn	faire le deuxième côté
kàn hwὲn	faire le côté
fεnví	silure
cέnkὲn	silure
fὲn	silure avec trois nageoires renforcées piquants
yàyà	être
kέɖέ	simplement
kέɖέέ	simplement
kpowùn	simplement
nùgbó	être sincère
ɖò tè	être sincère
ɖò	être sincère
abawè	espèces
hă gbonɔ	mâle
tɔklààn	couleur avec le
aklààn	jaune
klààn	jaune
zìnblàwewé	à
wŭ	sinon
ahanviví	sirop
kpέnglà	sixième dabomey
kú xomε	pas être
gεlεdέ	société secrète
ganbaɖà	société secrète sorciers
asi asì	bellesoeur
dadà	grande soeur
dadà	soeur aînée
ahangbè	soeur
sέdà	soie naturelle ou artificielle
sinnugblà	soif
xò bò	soif
xú mε	avoir soif
sìn gblă mε	avoir soif
sinnugblă sìn mε	avoir soif
kpé nukún wŭ	soigner
dŏ amà mε	soigner maladie quelquun
akpà	soigner une plaie
xò akpà zò	soigner une plaie
xò akpà zò	soigner une plaie avec leau froide
zìn wŭ	être soigneux
bó nú	soin
nukúnkpédómεwú	soin
bowliwlí	le fait soin
gbadà	soir
gbadanu	soir
hweyixɔ	soir
zànkúkú	soir
gbadanu	soirée
gbadanu	dans soirée
kpàn kpàn	soit que soit que
kpàn kpàn	soit soit
kanɖé	soixante
kanɖé gbàn	soixante
kanɖé gbàn	dix
hwezivɔ glaglà	brûlant
hwezé	comme lumière
nyànyà	torride
jànjàn	solide
syέnsyέn	solide
tεkowò	solide
wŭtù	solide
dὲ kàn	être solide
syέn	être solide
syέn kàn	être solide
syέn dà	être solide
nagùn	solide et vigoureux
jangbanjangbàn	solidement
syέnsyέn	solidement
tànwúntànwún	solidement
xò tò	pas être solidement fixé
kpàntyàngàn	solidement planté debout manière obstinée
kpànwúnkpànwún	très solidement
càɖàà	solitairement
kàdàà	solitairement
nukúnkpédómεwú	sollicitude
nukúnkpénùwú	sollicitude
wlɛnwínɖíɖé	le fait chercher une
flí xwè	sombrer
sín mε	avoir sommeil
ɖò mὲ	être plein sommeil
wunzὲn	navoir pas sommeil
sà	sommeiller
ɖò jĭ	être au sommet
azàn	le sommet arbre
zàn	le sommet arbre
amlɔtínkὲn	somnifère
sìn mε	somnoler
nyì bɔlŭ	somnoler
sà	somnoler
asi tɔn asú	beaupère
kpεngbe	flûte
vĭ gùdó	enfant
kpεngbe	du
vì sú	gendre
kú	faire songe
kú	songer
lìn	songer
gannxóxixo	sonner
kún lanzò	sonner
xò gàn	sonner
bò	sonner une
xò gàn	actionner sonnette vélo
caɖagan	sonnette que lon faire quen retentir devant cortège femme du dabomey écarter tous les hommes
lélé	voix sonore
lélélé	voix sonore
mĭnɔna	nom générique et religieux sorcellerie
ɖŏ azĕ	être sorcier
ɖŏ azĕ kà	être sorcier
ɖŏ	être sorcier
ɖù azĕ	être sorcier
tεnmε tεnmὲ	différentes sortes
nàhún	quelle sorte
tεnmε tεnmὲ	toute sorte
hămὲhămὲ	toutes sortes
nukúnmέ nukúnmέ	toutes sortes
blŏ ní sù ɖàxó	faire sorte que
sùn	faire faire première à enfant et mère
sùn nú vĭ	faire première
vìfléflé	loeuf
azĕ	sortilège
bòɖònúmε	faire des sortilèges contre quelquun
bŏ nyanya	faire des sortilèges contre quelquun
sà bŏ gbè	faire sortilège faveur quelquun
nyà	faire sortir
nyà mε	faire sortir
nyà sέ dó	faire sortir
tún	faire sortir
ɖè sín	faire sortir
xwí sìn	faire sortir leau
ɖè hùn	faire sortir les nouvelles recrues du couvent vaudoun
ɖè nŭ nyì tè	faire sortir quelque
flé	faire sortir quelque enveloppe
tún mε	faire sortir quelquun
ɖè sù	faire sortir quelquun du couvent
jὲ tè	sortir
flé azìn	sortir loeuf
flé vĭ	sortir loeuf
flelè	sortir terre
kpà	sortir cavité naturelle traversant paroi
kpódó kpó	sortir
kùn	sortir bourgeon
mεɖimε	sosie
xlò	être
yɛyi	être
lŭ	être
lŭ nŭ	être
yɛyijijo	sottise
yɛyijujo	sottise
gbà	faire des sottises avant lâge
dŏ kún	faire souche
tamεlinlin	souci
gbà tamὲ nú	faire du souci à quelquun
adì cì mε	faire du souci
adì hù mε	faire du souci
hù mε	faire du souci
ɖŏ hŭn mὲ	faire du souci
kéyà	soucier
kíyà	soucier
wŭ	être soucieux propreté
vawùn	soudainement
cà	souder
cà gàn	souder
kpé	souder
tlέ	souder
nùtítlέ	soudure
fún funfún	souffler
ɖè kpà mε	souffler à loreille
fún zò	souffler le
futukéɖé	soufflet traditionnel que lon actionne verticalement chaque
gbà tómὲ	souffleter
nyì zò nú mε	souffleter
xò	souffleter
nyì zò nú mɛ	souffleter quelquun
nùvìvέ	souffrance
wὲn	exprimer souffrance
cì mε	souffrance
ɖù yà	souffrir
jì yà	souffrir
xò kévè	souffrir
dŏ yà nú mε	faire souffrir
ɖè dŏ mε	faire souffrir
dŏ yà nú mɛ	faire souffrir
wà nŭ xà mɛ	faire souffrir
yajiji	le fait souffrir
sinnugblă sìn mε	souffrir soif
wùvέ	souffrir moralement ou physiquement
ɖù yà	souffrir terriblement
ɖumú	soufre
ɖεxixo	souhait
jìjló	souhait
céké céké	à souhait
ló	particule à exprimer souhait
dŏ vodún mε	souhaiter des malheurs à quelquun
xò nú vodún	souhaiter du à vaudoun
dŏ vodún mε	souhaiter du
xò ɖὲ nyanya	souhaiter du
dŏ xwè gbe nú mɛ	souhaiter fête à quelquun
xò ɖὲ nú mε	souhaiter quelque à
hὲn gblĕ	souiller
và nŭ	souiller quelque
babà	souiller boue
fàn babà	souiller boue quelquun
nŭ mɛ wŭ	souiller une fille
ɖăkpεɖὲ	souillure
nùkwíjí	souillure
dŏ fífà	soulager
yì nùkàn mὲ	soulager
nă mε	soulager quelquun
sinmεnù	soûlard
dŏ ji	soulever
yì jĭ	soulever
ɖónyà	soulever
xò zĭn	soulever
dεὲn	soulever
zĕ	soulever objet
glogínù	souliers ferrés des soldats
jŏ nú mε	soumettre à quelquun
nŭ nú mε	soumettre à quelquun
nyì akàn	soumettre à
nyì kàn	soumettre à lépreuve corde
kpé aɖĭ	soumettre quelquun à lépreuve du
kpé aɖĭ nú mε	soumettre quelquun au dépreuve
ɖŏ tè nú mε ɖé	soumettre une affaire à quelquun
nùvὲdómε	soupçon
vὲ nŭ dŏ mε	soupçonner quelquun quelque
vὲ ajò dŏ mε	soupçonner quelquun
dàn	soupeser
xò	soupeser
gbigbɔjέ	soupir
tɔtaligbé	rivière ou fleuve
nukúntàfún	sourcil
kú tó	être sourd
ajakawlíjà	souricière
kò nŭ	sourire
sɔsumàsèɖĕ	sorte souris à touffue dangereuse
ajaka hètó	souris chapardeuse
hètó	souris grise au ventre
awlinmεdàn	sournois
mε blublú	sournois
asà	sous
nŭ	sous beaucoup rapports
mε así	sous dépendance quelquun
tàvo gwlέ	sous
atínsà	sous larbre
totínsà	sous larbre à palabre
lòkósà	sous le roco
ɖò pilàtu sí	sous
ɖò pilàtu sí	pilate
hwè sín mὲ	soustraire
găn	soutenir
dé wú nú mε	soutenir quelquun
yì gbé	soutenir une
alɔdómεtɔ	soutien
jὲ gblŏlŏ mὲ	navoir aucun soutien
anɔblanú anɔbέnú anɔwlinú anɔwlíwú	soutiengorge
bŭ wăn	quelque ou quelquun
bŭ wùn	quelque ou quelquun
bŭ	quelquun
bŭ nyĭ	quelquun
flín mε	quelquun
mεflínflín	quelquun
gègé	souvent
hwεhwὲ	souvent
xàgàn	spécial
sù	spontané
wezunkínkàn	le
xú gló xùgblàgblà	squelette
glàóglàó	squelette
govíkàcwé	squelette
kàcàkàcà	squelette
bobò	bois ou terre
vìmàjí	stérilité
lŭ	être stupéfait
mεsegàn	stylée
mεɖomεsí	subalterne
sún sìn	subir mauvaise
sὲn gàn	subir lemprisonnement
nyì kàn	subir lépreuve corde
ɖù aɖĭ	subir lépreuve du
ɖìɖà zĕkpeté	subir les conséquences acte dangereux
kpowun	subitement
tlóló	subitement
vawùn	subitement
ní	subjonctif exprimant souhait ordre
dŏ mε	submerger
kpò ɖò	subsister
gŭdò	succéder
mε	succéder à quelquun
adlajídlají	successivement
cέwún	succinctement
jὲ mὲ	succomber à
wlĭ	être
dŏ súklè mὲ	sucrer
ɖiɖì	sucrerie du dorge
yovójɛgbàn	sucrier
tofɔligbé	le pays
dεnjijέ	sueur
kpé	suffire
kàflàkà	suffisamment
kpíkpé	suffisamment
nú mε	avoir à suffisance
kpé	être suffisant
sù	être suffisant
kpé	suffoqué
hù mεɖé	suicider
gŭdò	à
jὲ gŭdò	suivre
kplà	suivre
dŏ	suivre
xwè dŏ mɛ	suivre
lanxwíɖàxwíɖà	suivre le gibier à
dŏ mε	suivre piste quelquun
xwíɖà	suivre le gibier avec précaution
jὲ gàn	suivre le rythme
dŏ	suivre les traces
jὲ mε gŭdò	suivre les traces quelquun
xwíɖà	suivre ou quelquun
jὲ túnnu mεɖé	suivre quelquun
alì	suivre chemin
ɖŏ tamὲ	au sujet
ɖŏ wŭ	au sujet
ɖò wŭtù	au sujet
gblamὲ	au sujet
kúkúmàkwí	summum
yɛmɛnuwiwà	supercherie
yɛnuwiwà	supercherie
kpò ɖé jí	superflu
mεɖómε	supérieur
mεhúgănmὲ	supérieur
hăgà	à niveau supérieur
hŭ găn mε	être supérieur à quelquun
gànhúmε	supériorité
cúcú	idée superlatif
nyagoò	le superlatif avec lactif vovà
cwícwí	même sens que cúcú dans le langage enfantin
jàwún	superlatif à dur
foò	superlatif à wèwé
tété	superlatif à wèwé
pépé	superlatif au verbe wĕ
pépépé	superlatif au verbe wĕ
twέtwε	superlatif fà
tyέtyέ	superlatif fà
dúdú	superlatif
cέcέ	superlatif
cécé	superlatif mέ
nà	supplément
kέn	supplément
xúnà	supplément
nyì mὲ	faire supplications
hὲn nú mε	quelquun
cì kpὲ nú mε	quelquun avec insistance
jὲ nú mε	quelquun avec insistance
zanhwlahwlà	supports du matelas ou natte
ɖò yŏzò	chaleur
dὲ ɖò jɔhɔn	le froid
yà agbàn	une
sín ì	supprimer
sú kún dŏ	supprimer
xlà	pas supprimer
gblĕ mε	supprimer le
vĭ sìn	suppurer
ɖò jĭ	être
kpeta	marche
gbεmε fí	terre
ɖokpó	le
caà	le
tlóló	le
alita	le
alixò	le
lixò	le
ajɔlinú	le chemin du
ajɔlixò	le chemin du
kú zan jí	le
azata	le plafond
gĕ	le
kɔxò	le
kpeta	le seuil
wé	le sexe père
atɔwé	le sexe père
tlóló	lheure
àcéjí	ses gardes
gŏmὲ	soi mais caché
lélélé	très élevé
kpannyawùn	sûr
là	sûr
ɖè jì dŏ wŭ	être sûr
tὲ jĭ	être sûr
cícà	suranné
cà	être suranné
sà	être suranné
mε nú	surélever
ɖò sìn nukúnmὲ	être à leau
xwè	surgir
kplàkàsέ	qui surmonte lautre
kplέkέsέ	qui surmonte lautre
aglavún wesú	surnom appliqué au
aglavún wèsú	surnom
kolíkò	surnom hlà lhyène dans les récits légendaires et les proverbes
gìcàn	surnom tortue
kanlinɖujὲ	surnom lhomme
dɔkunnɔ	surnom sakpata
agbò	surnom des amazones du royaume dabomey
daàgà	surnom donné à homme grande
fofó	surnom du frère
kinikíní jawuntà	surnom du
kinikíní	surnom du glεlὲ
hiì	surprenant
jĭ wŭ	être surprenant
kpàcà	être surprenant
fyàn	surprendre
gbò dŏ	surprendre
hὲn hŭn nú mε	surprendre
dŏ mε jĭ	surprendre quelquun
gbò mε dŏ	surprendre quelquun
hŭn nú mε	surprendre quelquun
hŭn xà mε	surprendre quelquun
dŏ mε jĭ	surprendre quelquun délit
ò	qui
sí nŭ	sursauter
nyĭ	surveiller
zăn	surveiller nuit
jὲ	survenir
wă	survenir
ɖŏ tè	suspendre
dŏ azàn glé mὲ	suspendre
kplà	suspendre
dŏ	suspendre au cou
sà nŭ dŏ kàn ɖŏ jĭ	suspendre quelque à une corde
nŭ dŏ kàn ɖŏ jĭ	suspendre quelque à une corde
jawuntà	symbole et terreur
kinikíní jawuntà	symbole
mε	être sympathie avec quelquun
jì	du jinúkun
asi towe	mère
gbŏke	tabac
azɔkplá	blague à tabac
azɔfúnfún	tabac poudre
azɔfúnfúngbá	tabatière
batakín	tabatière
fú	nom du des principaux le fá
gbè	nom du des principaux le fá
kataklὲ	tripode seule pièce
katakὲ	tripode seule pièce
gùn	peau
kán nú mε	faire travailler à tâche
hwὲn	tâche
xò	tacher
và nuɖé dó mε wŭ	tacher quelquun avec quelque
và dé wú	tâcher
wŭ	tâcher
syέn xú	tâcher
dŏ gŏ	tâcher réussir dans une entreprise
kpàn	être taciturne
jă	taillader
ɖò hă jĭ	être même
hwè glì	être
gbò	tailler
kpà ɖà	tailler
hùnkpátɔ	celui qui les pirogues
kán aɖŭ	tailler les dents pointe
slá	tailler avec le
kán	tailler dans pâte cuite
kpà awĭnyà	tailler des pierres
kpà atán	tailler le coeur du palmier faire venir le vin palme
ɖà	tailler légèrement les cheveux les bords
kpà	tailler superficiellement
atínkánmὲ	taillis
nabɔέ abɔέ	taire
xwɛ	taire
dŏ wŭ nú mε	taire les agissements répréhensibles quelquun
kpàn	taisant courageusement ses soucis
kpàn	taisant courageusement ses peines
kpé agbàn nú mε	faire pouvoir garder enfant qui vient au monde après le décès frère
botoyí	faiseur
zìndòbó	le utilisé rendre
kpekú	nom
sánlín	sorte
kíjá	sorte qui à semer du entre deux ou plusieurs personnes
cakatú	sorte qui agit à
asánlín	et
asánnyí	et
tílà	enfermé dans et contenant une magique
atínmá	fait avec des feuilles darbres
bòkún	liquide
awlé	les acheteurs
awlé	lestime des
nùdónùmε	empoisonner
nùdónùmε	obtenir quelque
gogbahún	sorte
gogbahún	vaudoun
kpánù hŭn	des assiettes
kú hún	des morts
gàngánwún	entouré cordes
gota	les défunts
cεnkúnmε gohún tɔhún	tamtam les défunts chez les maxi
hwεɖὲ	vaudoun
masὲ àcá	groupe tamtam
jevívítín	tamarinier
tɔhún	leau
gàngáwún	des des yoruba
zokwété	des nɛsúxwé
kpezìn	fait jarre entourée vannerie
dogbá	dabomey
hŭn	appelé couramment
kùtítùhùn	variété
hùntɔ	tambourineur
gixwínú	sorte filtrer farine dans leau
dugbà	gari
linfín	tamiser farine
gbà galí	tamiser le gari frais avant torréfaction
dŏ galí abɔbɔ jí bó ɖù	tamiser le gari frais avant torréfaction
xwí gí	tamiser le gí dans leau
zĭn dŏ jĭ	tamponner
ɖà anyŭ	le
tásí	tante maternelle
nagán	tante maternelle âgée que mère
nafí	tante maternelle jeune que mère
daá	tante paternelle
noví	tante paternelle
zìngídì	tapage
xò zĭn	faire du tapage
zĭn wĕmà	à
zìn dŏ	contre
zìn dŏ ayĭ	du
hŭn	le
hwenu dĭn	être tard
sέxlò	targette
cigididɔ	tas saletés
cigididɔ	tas dordures
ɖìɖó	tas
sónú	tas
cyán kplé	faire tas choses triées
klísì	faïence ou porcelaine
klísìví	faïence ou porcelaine
kpíwúnkpíwún	tassé
zĭn ayìkúngban	le
ɖŏ wŭ	tâter
dŏ wŭ	tâter
hὲn	tâter
xò	tâter voir
avì	à tâtons
avidladlá	laction chercher à tâtons dans le
gbò kisí	faire tatouage
hwὲ	tatouage
hwεgbigbo	tatouage
hwεgbugbo	tatouage
gbò hwὲ	tatouer
nyìbú asú	taureau
nyibúsú	taureau
kán akwέ nú mε	quelquun
nú mɛ	quelquun
tέkigbò	teckeraie
tέkikàn	teckeraie
dŏ ahŏ	teindre à lindigo
dŏ yowunbó ɖà	teindre les cheveux
jὲ ká	avoir le teint clair
sìn	teinte
ahŏ	teinture dindigo
yowunbó	teinture noire les cheveux
ayì	tel quel
kpabaà	tel quel
kantitε	télégramme
kantε wemá	télégramme
dŏ mε	télégraphier
tὲ kàn	téléphoner
tὲ kàn sέ dŏ mε	téléphoner
ɖáɖà	tellement
glă	être téméraire
glàglá	témérité
ɖè kúnnú	faire faux témoignage
ɖè kúnnù	faire faux témoignage
ɖè kúnnù	témoigner
ɖŏ xá mε	témoigner lamour
mɛ	témoigner beaucoup à quelquun
ɖè gbĕ nú mε	témoigner bonne foi quelquun
tómὲ	tempe
jɔhɔn syέnsyέn	tempête
dangbé xwὲ	des serpents
tὲn	temps
tὲn mὲ	temps
dŏ hwenu	temps
tὲn	avoir du temps
tán	avoir du temps
vivò	avoir du temps
vuvò	avoir du temps
xóxó hwénú	dans lancien temps
jixómὲ	dans le vieux temps
jixómὲ	dans les temps anciens
hwebĭnu	temps
lè hwénu	temps
lè hwénu	ci
hwenέnú lɔ	temps
hwenέnú lɔ	là
dŏ gàn mὲ	être à temps
sín hwenu	le temps du
nù dò hwénú	le temps des semailles
gbεmε cí kpitiì	le temps est couvert
gbεmε ă	le temps est couvert
gbεmε cí kpitiì	le temps est
nukɔnmὲ	le temps futur
hwenu xóxó ɖáyi	le temps jadis
xixo hwenu	le temps où lon peut être corrigé
hwenu è mĭ ɖè	le temps présent
afɔdlέn hwεnu	temps détente
xo hwenu	temps grossesse
zò hwénú	temps saison des pluies
gbógbó	temps éloigné
avέntu	temps liturgique
xuxo hwenu	temps où lon peut être frappé
syέn	être
xwè nŭ	être
akobέ	tenailles
bɔklè	tendre
vὲná	tendre
mɔɖuɖó	le fait tendre piège
mɔɖónúme	le fait tendre piège à quelquun
tέ	tendre
sín hŭn	tendre peau
dà gă	tendre larc
tέ tó	tendre loreille
tó	tendre loreille
nŭ tó	tendre loreille quelque
nùfέnúfέ	tendre pousse terminale branche
ɖŏ fέcà	tendre piège
ɖŏ	tendre piège
hὲn	tenir
ɖù sù	pas tenir compte des habitudes quelquun
hìhí wŭ	pas tenir
bŭ dò	pas tenir promesse
nŭ	tenir compte daucun
nŭ	tenir compte daucune barrière
nŭ	tenir compte daucune loi
dŏ wŭ	tenir à côté
cí tè	tenir debout
tè	tenir debout
xwè tè	tenir debout
bà wì	tenir réserve
jὲ hùn dŏ nŭ jĭ	tenir à
hὲn hŭn nú mε	tenir à coeur à quelquun
ɖŏ vò	tenir à lécart
ɖŏ ayì jĭ	tenir compte
gbò gbĕ nú mε	tenir compte personne
zĕ hὲn	tenir dans
dafέ	tenir des propos badins
xò	tenir des propos badins
yĭ kpá	tenir des propos confidentiels
nŭ jí	tenir
sìn adăn	tenir fortement
mε sín ɖŏ tè	tenir à quelquun
dŏ	tenir le suivant
gbè	tenir tel ou tel propos
gbà mε	tenir tête à quelquun
nuɖé dŏ mε wŭ	tenir objet tellement cher quon le céder à autre
àă	tiens
àăn	tiens
cá	tiens exprime douleur lindignation
caá	tiens exprime douleur lindignation
cáyì	tiens exprime douleur lindignation
hùn hú găn mε	avoir
ahwangoxò	tente militaire
tέn mε	quelquun
jὲ àcɔ	sorti tenue
abὲdăn	tenue très
ahwanawù	tenue militaire
zatín	térébinthe
xò	tergiverser
vĭ	être à terme une femme enceinte
kásá kásá	terminé
kásáá	terminé
tutú	ailé essaimage
agbotlà	à grosse tête
gbakwέgbakwέ	termitière
jè	être terni
kú awì	ternir
hankán	cultivé à précédente saison
jɔmεhúnjayitὲn	daviation
nùkán	envahi des grandes herbes
gbèhánmὲ	inculte envahi les herbes
kέntέnmὲ	rocailleux
nyὲkέntέnmὲ	sablonneux
zĭn dŏ ayĭ	terrasse
nyì dŏ ayĭ	terrasser
zìn dáyĭ	terrasser
zìn dŏ áyĭ	terrasser
zĭn	terrasser
zìn mε dŏ ayĭ	terrasser quelquun
gbεmὲ	terre
dŏ ayĭ	à terre
xwlakɔ	terre
xwlakɔ	popo
lí	nom sacré terre
glè	terre cultivée
glelilὲ	terre cultivée
gbĕ jeké	terre désolée
didε	terre pétrie
nyinya	terre pétrie
mlímlí	terre pétrie et roulée boules
vεsísá	terre sablonneuse
vεyisá	terre sablonneuse
ayikúngban vatankpánnyá	une terre complètement boueuse et glissante
xɛsi ɖaxó	terreur
nylăn dŏ	être
dŏ xɛsì nú mɛ	quelquun
adànzún	tertre bravoure
mε towe lέ	tes amis
dòkó tówè	tes ancêtres
mε towe lέ	tes parents
goxwὲ	tesson bouteille
adogannú kpέtέ	tesson et recourbé quon emploie caler le
sέn xóxó	lancien
akɔjijε yàɖéyàɖé	le nouveau
sέn yaɖé	le nouveau
yaɖé	le nouveau
nὲkwín	testicule
akplɔkàn	bourses avec les testicules
akplɔkànkwín	bourses avec les testicules
akplεkàn	bourses avec les testicules
katikatì	tétanos
tamὲ	tête
hùn ɖù	avoir tête troublée
ɖŏ tamὲ	avoir toute tête
aglɔkpò makpo tagbanú	cassetête
ɖò mε	être dans tête quelquun
jὲ aglăjà	faire tête
kóɖókóɖó	tête
tasúnsún	tête chauve
ɖèkpáta	tête du palmier
kákέtín	tête comme le kàke
takpédò	tête tournée vers le
syέn	têtu
cí tamὲ	être têtu
kpὲn	être têtu
tì tamὲ	être têtu
tlí tó	être têtu
xú tamὲ	être têtu
sìn	tiédir leau
mε towe lέ	les tiens
wè	tienne
àànyí	tiens
ké	tiens
kée	tiens
donu	le tiers
ɖŏ	le tiers
aziínkàn	après récolte
sεkàn	chiendent
gbaɖé hán	maïs
kàn	plantes sarmenteuses
hankán	tiges des céréales déjà récoltées
xeɖulinfín	rampante qui produit des petits fruits rouges
xɛlinfín	rampante qui produit des petits fruits rouges
tilapia nilotica	tilapia
tέnblù	poste
kpàn	être timide
kú winyá	être timide
aɖɔwé	tique
găn	être tiré daffaire
nukúnhúnhún	le fait savoir daffaire utilisant beaucoup relations
nyì klohwán dŏ mε	à fronde contre quelquun
nyì dŏ	au objet
nyì dó nŭ	au objet
lùn sὲ	paille tas
ɖù lè	des bénéfices
ɖè sò dŏ nŭ	des coups quelque
lùn	du dedans
dà	et manquer le
tún	langue
gbìdí nú mε	les vers du nez
fέ gblă	quelque et le manquer
xwì dŏ nŭ jĭ	dessus
dà gă	une flèche
lɔn	tisser
asansán	fait morceaux tissu couleurs et dessins différents
botoò	sorte tissu très marché
sígí	tissu à petits carreaux
cígán	tissu cher
vedomε	tissu deuxième qualité
nyinya	tissu lavé
cíví	tissu peu cher
cígán	tissus qualité supérieure
kuwuntú	tissu
daágbó	donné aux évêques chez les catholiques
daá	donné aux rois
fún	tituber
fún sà	tituber
ajalá	toile coton écru
cakì	toile plastique
cányínyí	intime femme
cá	intime que les femmes juste après le
nùgúdò	toilettes
fún nukúnmὲ	faire intime
gbò jă	faire déshabiller complètement
wŭ	faire une rapide savon
yì nùgúdò	aux toilettes
xɔta	le
kpánù	tôle
xɔgbágánnú	tôle employée une toiture
gbŏ	tomate
timáti vivó	tomates très mûres
timáti vuvó	tomates très mûres
nŭ gbέ dŏ mε	être tombé dans misère
yɔdò	tombeau
zɛbὲ	tombeau où lon creuse
akpásá	variété tombeau
flέ	tomber
jὲ	tomber
jὲ ayĭ	tomber
hŭ dέ	faire tomber
kpíkpé	faire tomber
zìn	faire tomber
zĭn	faire tomber
zĭn dŏ ayĭ	faire tomber
lùnlún	faire tomber des feuilles ou des fruits
zìn mε dŏ ayĭ	faire tomber quelquun
xò mɛ zin dáyĭ	faire tomber quelquun terre
taɖuhunhun	le fait tomber dans
kεnxuxɔ	le fait tomber inimitié avec quelquun
jὲ àyĭ	tomber à terre
jàyĭ	tomber à terre
jὲ	tomber daccord
jὲ xá mε	tomber daccord avec quelquun
jὲ	tomber dans misère
jὲ gblŏlŏ mὲ	tomber dans le vide
jὲ lĭkpà mὲ	tomber dans lindigence
jὲ	tomber dans une étendue deau
jὲ hwὲ mὲ	tomber dans une faute
flέ sín	tomber
ɖì jὲ	tomber soi même des fruits mûrs
sà	tomber sommeil
flέ	tomber arbre
nŭ	tomber défaillance
ɖù afɔkú	tomber disgrâce
jὲ kὲn xá mε	tomber inimitié avec quelquun
kὲn xá mε	tomber inimitié avec quelquun
sùn cí tè nú mε	tomber enceinte
kùn	tomber à
kùn téwún téwún	tomber à
xwè dò	tomber contre terre
xwè sú dò	tomber contre terre
adăn	tomber malade
jὲ	tomber malade
jὲ lanmὲ	tomber malade
lanmε wá nú mε	tomber malade
xò	tomber terre et être sali
ɖè atán	tomber quelques gouttes pluie
lùnlún	tomber successivement
jὲ jĭ	tomber
dò	tomber tête
jὲ mε jĭ	tomber quelquun qui puisse daffaire
jὲ jĭ	tomber une porte fermée
anɔwe nɔgbó anɔwe wè	grandpère paternel grandmère maternelle
kpà ɖà	tondre
kpà fún	tondre
ɖà	tondre les cheveux
kpa fún	tondre les poils bête
sò nyì awăn	avec
jì vòdún	tonnerre
xεbyoso	tonnerre
dadesò	tonnerre et rapproché
lă zogúdó	faire
kú sú	pouvoir une
sέ sέ	des doigts
zohwĭn	torche
fú	torche faite branche palmier fendue et utilisée sève du palmier
gbăn	tordre
gbàndán	tordre
gbὲ	tordre
sín nuɖé mὲ	tordre du
sló kàn	tordre une liane faire une corde
gbìngbán	tordu
klέjεὲ	tordu
lεgεdὲ	affaire tordue
gbăn	être tordu
wlŏ	être tordu
gbàndán	être tordu
klέcέέ	tordu
gbà hŭn	torpiller
nyànyá	torride
wayawayà	à et à travers
nylă	avoir
kú	avoir
hù dŏ mε	avoir envers quelquun
blŭ	faire du à
hù dŏ mε	faire du à quelquun
zĕ nyì gbĕ	avoir le torticolis
akpatá logozò	tortue
akpátá logozo gicán	tortue
sé	espèce tortue deau
xumε logozò	tortue mer
tɔklò	tortue deau
gbìngbán	tortueux
gεdεdὲ	tortueux
gὲdὲgέdέ	tortueux
gεdεὲ	tortueux
gὲdέ	être tortueux
ɖù wùwέ	être à
ɖù yà	être torturé
dŏ yà nú mɛ	quelquun
kásá kásá	totalement
kásáá	totalement
vεὲn	totalement
zìn	être totalement formé
hùn	être totalement ouvert
kέyέkέyέ	totalement démuni
kpέncέnkpέncέn	totalement imprégné liquide
ɖò sέ gbè jĭ	totalement
kpíkpé	totalité
kpétè	totalité
mlέmlέ	totalité
hŭn zὲ	être touché
zὲ hŭn nú mε	être touché
và dé wú	à
sí	avec du
zĕ dŏ nú mε	avec à tête quelquun
ayì bó	terre puis poitrine
sá fὲn	longle
fὲn	longle
hùnhún ayì	le coeur
ɖŏ nŭ wŭ	quelquun
xò zò mɛ wŭ	quelquun
ɖù ɖò lanmὲ nú mε	quelquun
sí zò mε	rapidement quelquun avec du
acugwidi	touffe cheveux au sommet du crâne
hiyεhiyὲ	touffu
hiyεε	touffu
tεgbὲ	toujours
ɖĕ jὲ ɖè gúdo	à rôle
mεjíjὲ mεjíjε	à rôle
nŭ sìn kàn mε	être au quelquun faire quelque
sìn jĭ	être le
jὲ mε jĭ	être le quelquun
dŏ	faire le
kpé	faire le complet
mεjíjὲ mεjíjε	à
aɖawùn	dadresse
hùzùhúzwí	tourbillon
xásáxásá	tourbillon
dŏ yà nú mɛ	tourmenter
lìlέ	tourner
kpàn tà	tourner vers
kpé nukún wŭ	tourner vers
kpàn	tourner vers
hùzú kpán mε	tourner vers quelquun
dŏ nŭ	tourner autour quelque
hùn wĕmà	tourner
dŏ gŭdò mε	tourner le à quelquun
ɖè	tourner le côté
nukún	tourner les yeux
flé nukún	tourner les yeux
nyì	tourner les yeux vers
cá mε kò	tourner quelquun
mε kò	tourner quelquun
wlă mε kò	tourner quelquun
amijá	tourteau
kplεbε	tourteau fait avec les résidus des cerises palme
bĭ	tous
mε tobútobú lέ	tous ces là
atín kpó kpó bĭ	tous les êtres
gbèbígbè	tous les
yɛhwe bì zán gbè	toussaint
kpέn	tousser
kpέn kpέn	tousser
ká mε mὲ	dans
ɖaxó hú mɛ bĭ	être le tous
agbà	à fait
jέn	à fait
klókló	à fait
kplá mε yì bŭ	à fait
pέpέ	à fait
pέpέpέ	à fait
kpoɖó	à fait à
kpoɖokpóɖó	à fait à
pépé	à fait
pépépé	à fait
kpεcεὲ	à fait mouillé
wiwi dúdú	à fait
amamù fεέn	à fait
kújέkújέ	à fait vieux
dégbédégbé	entier
kpétè	entier
vεlεὲ	juste
cεὲn	juste au
bĭ	toute
dinzaanɖé	toute à lheure
zaanɖé	toute à lheure
bĭ	toutes
kpέn	toux
tagbadudó	le fait du tracas
jὲ tagbà nú nŭ	tracasser
dŏ tagbà nú mε	tracasser quelquun
wà nŭ xá mɛ	tracasser quelquun
fὲn nú mε	faire des tracasseries
mεfunfun	tracasserie faire agir
fεnfɔnúmε	tracasseries causées à quelquun
xwà	bave desséchée qui reste après le sommeil
xwaxwá	bave desséchée qui reste après le sommeil
ɖuɖuxwà	bave desséchée qui reste après le sommeil
afɔkpadò	semelle
ɖè hwὲn	le
ɖè alì	chemin
ɖè yehwín	sentier
xwì	une
tín mὲ	traduire
hwὲ	traduire
sè gbè nú mε	traduire quelquun
slέ	trahir
zĕ mε yì jŏ	trahir
gbà mεɖéé dŏ	trahir
zĕ mɛ jŏ	trahir quelquun
mεsíslέ	trahison
mεslέslέ	trahison
síslέ	trahison
slέslέ	trahison
gbligblì	à fond
xwè gbé	être daller
ɖò wezùn jĭ	être courir
xwè	être déplacer vers
kpò ɖò	être
lεkanlεkàn	le fait traînailler
sεὲ	traînant
àfínhwέkán	traînée
sà lelè	traîner
sá mὲ	traîner terre
dέ	traîner les pieds terre
dŏ ayĭ	traîner les pieds terre
mὲ	traîner terre
sà	traîner terre
sà dŏ ayĭ	traîner terre
sà mὲ	traîner terre
sὲ mὲ	traîner terre
blĭ gbò	traîner vélo
àfínhwέkán	couleur cendrée
nùbyáxà	desprit
kàn	traits physiques
àkwέwémá	traite
gbèjé	traiter
wà kò dŏ	traiter délicatement
bà hă mε	traiter trop familièrement supérieur
bà dò nú nŭ	traiter supérieur égal
bàlúnlúnamà	désigne qui est tranchant
ɖă	être tranchant
tikpò	qui pas tranchant
xɔdo	tranchée asseoir le mur
ɖă	trancher
gbò	trancher
sέn	trancher
hwὲ gbò	trancher différend
gbò hwὲ	trancher différend
gbò hwὲ nú mε	trancher différend quelquun
gbà xó	trancher une affaire
gbò xó	trancher une affaire
dŏ ayì dò	tranquilliser
xò mε hùhwέ	tranquilliser quelquun
cúɖúɖú	tranquille
kú hŭn	tranquille
hŭn ɖò agà	pas être tranquille
xwíí	tranquillement
gedemὲ	tranquillité
ayijàyĭ	tranquillité du coeur
ayijεdò	tranquillité du coeur
dŏ asá	transgresser
hὲn gblĕ	transgresser
dŏ asá sέn	transgresser commandement
gbà sέn	transgresser interdit
gbà sέn	transgresser une loi
ɖì	être
hwăn	transpercer
xò	transpercer
jὲ	transpirer
gbatὲ	marchandise ou fardeaux moyennant salaire à gages
blă gbĕ	traquer
xò	faire les petits travaux qui présentent
flú	laccouchement
vìnú	lenfantement
mεɖè	à lépoque coloniale
gbatὲ	occasionnel gagner quelque
wà	travailler
tozɔwiwá	le fait travailler le du pays
xò zò cí	travailler à éteindre le
wà kínkán	travailler à tâche
tùn	travailler artistement les métaux
atín	travailler dans menuiserie
xò zăn	travailler nuit
kpà atín	travailler le bois
sín ká	travailler une calebasse
kpà kέn	travers
nyidò	travers
gbăn	être travers
nuĭ dò	être travers
jlŏ ă	faire travers
zan kpotín	natte ou le matelas
sá	fleuve
flέ	une lagune
kpá	une palissade
sá	une rivière
flέ	une rivière à
gbà	trébucher
klέn	trébucher
mɔ	trébuchet
kikikì	tremblant froid
ayìkúngban hunhún	terre
kɔxέ	trempé
kɔxέ	trempé sueur
gì	faire tremper le maïs faire le gi
cí atá	tremper dans le beignet
sún nùsúnnú	tremper dans
kán bó sún nùsúnnú	tremper pâte dans
cí gàn	tremper le fer
cí atá	tremper le peigner haricots dans lhuile
gbàn	trente
saɖexwéjὲsú	trépas
zinkpò	trépied
kpitikpitì	trépignant
manamanà	trépignement
tamatama	trépignement
kì jò	trépigner
sún manamanà	trépigner
sún tamatama	trépigner
ɖésú	très
dín	très
taala	très
flá ayĭ	être très abondant
hùn nukún	être très
kpéké nú mε	être très fatigué
sìn	être très
kpὲn kpó	être très lourd
vìvó	être très mûr
vùvó	être très mûr
séfúnsefún	être très
gbĕlŭ	être très nombreux
tún flá	être très nombreux
myă nukún	être très occupé
gbì	être très usagé
kpò kàn	être très vieux
kákáká	très très
dɔkùn	trésor
dɔkùn	être trésorier
dɔkun jí	être trésorier
sí nŭ	tressaillir
ɖanyinyέ	tresse
ɖablablá	tresse cheveux
nyìnyέ	tressé
gbὲ	tresser
gbὲ kàn	tresser
gìn ɖà	tresser artistement les cheveux
ɖà	tresser des cheveux
kàn	tresser des
ɖà	tresser les cheveux
blă alìn	tresser les cheveux
gbàkún	tresser
gbὲ avokàn	tresser une corde
kàn	tresser une corde
zàn	tresser une natte
xweɖá	tribu qui habitait région ouidah
mε ɖù	tricher
blŭ	tricher
fìn	tricher
fìn nŭ	tricher
fìn nŭ wlăn	tricher écrivant
blŭjù	tricheur
mεblέɖútɔ	tricheur au jeu
souci	tricotage
nŭ	tricoter
séfúnsefún	trié le
cyán nŭ	des choses
cyán dèkín	les amandes palme
cyán nùkún	les grains
ɖò bŭ	trinité
xwè dŏ	tripoter
xò zò mɛ wŭ	tripoter quelquun
wŭ kú mɛ	être triste
wùbláwúblá	être triste
ɖò alwε mὲ	être dans tristesse
donu	troisième
mìmá	troisième partie
ajinakú	léléphant
lanzò	corne dantilope
lanzò	faite corne dantilope
lanzò	faite corne
blasaà	tromper
bàdá	tromper
bŭ alì	tromper chemin
nyidò	tromper comptant
nyidò	tromper parlant
xó	tromper parlant
flán	tromper parlant
mε ɖù	tromper les à
blŏ	tromper quelquun
ɖŏ nú mɛ	tromper quelquun
hìzí mε	tromper quelquun
wà xá mɛ	tromper quelquun
wà nú mɛ	tromper quelquun
xò asánnyí nú mɛ	tromper quelquun
bɔnyijí	tromper quelquun racontant quoi
bɔnuijí xá mε	tromper quelquun racontant quoi
bɔnyijí nú mε	tromper quelquun racontant quoi
xò mε ɖù	tromper quelquun avoir quelque lui
mεblεblέ	tromperie
nùvú	tromperie
yɛɖonumɛ	tromperie
yɛmɛnuwiwá	tromperie
yɛwiwa	tromperie
ahwankpὲn	trompette
kpὲn	trompette
nuvudoto	trompeur
xó fitifiti ɖé	une trompeuse
gbàví	quête
gbàvú	quête
atíngótó	darbre
golyó	humain tête et les membres
ɖáɖà	trop
kpludŏkpludŏ	façon trop rapprochée
kpé kpò	être trop
gblă	être trop
cololò	être trop liquide
cólólwé	être trop liquide
zùn sìn	être trop liquide
hwè sìn	être trop
takín	être trop pimenté
jὲ	être trop salé
blŏ axì nú mε	pas trop marchander
gblă	trop
gεὲ	trop personne
domὲ	dans le trou
ayìsúndò	trou creusé leau ruissellement
kpέndò	trou doù lon largile faire des briques ou des tuiles
bìbló	être
ayigbadó	desprit dû à peur
hὲn blŭ	état qui est troublé
ayì gbà dŏ	être troublé
ɖónyà	être troublé
hŭn zὲ	être troublé
gbà hŭn dŏ nú mε	le coeur quelquun
gbà ayì dŏ nù	lesprit quelquun
hlŭn	quelque
gbesò	trouée dans brousse
asúká	choc des rois dabomey
ahwàn	soldats
ahwan gɔnu	militaire
kplékplé	troupeau
aglúza	dans troupeau porcs le acheté
nyibú kplékplé	troupeau boeufs
kpέtέví	trousse décolier
sú gbă nú	faire le femme
vlafonú	trouvaille inattendue
flú	pas avoir trouvé objet malgré des indications précises
bà kpò	pas trouver
kpò	pas trouver à marier
kpò	pas trouver à honorablement
ɖè	trouver
jὲ	trouver
ɖò gbla mὲ	trouver parmi
ɖŏ gbla mὲ	trouver parmi
kínkέn xó	trouver à redire
àkwέ	trouver largent
nŭ	trouver recherchée dans une
gblă xú	trouver peu viande los
sùn	trouver mois
jὲ mε jĭ	trouver médiateur
tὲn	trouver
kpà ayì dé wú	trouver une à quelque
kpà ayì dŏ é wú	trouver une à quelque
akpὲ	sorte truelle
àglúzasì	truie
hù	tuer
hù mε	tuer
kpέn	tuile
zìnxúxó	tumulte
hlùnhlún	tumulte
zìngídì	tumulte
ɖŭ zìngídi	faire du tumulte
ɖŭ zìngídi xá mε	faire du tumulte
hìhí wŭ	être
hùhwé	être
mlă	être
mìmlán	le fait dêtre
kúkúmákwí	le nec
mε ɖé mε ɖé	lun lautre
ɖĕ jὲ ɖè gúdo	lun après lautre
tέnwínlεnwín	lun après lautre
céɖéɖé	lun derrière lautre
ɖĕ jὲ ɖè gŭdò	lun derrière lautre
fínù	quelquun dici
cè	quelquun du même âge que moi
ɖokpó ɖokpó	à
kplíkplí	uni
ɖŏ gbè xá	être unis
ɖò	être unis
ɖŏ	être unis
ɖŏ wŭ	être unis
ankóò	uniforme deux ou plusieurs personnes
hăɖotè	uniforme deux ou plusieurs personnes
hătè	uniforme deux ou plusieurs personnes
ɖóɖó	uniquement
ɖò	unir
kplé	unir
dŏ avà	génération parlant des animaux
cobwè	unir groupe qui opère quelque
gbεmὲ	univers
kέmὲ	univers
kέ	univers
ɖò jí	dans lunivers
yi	université
ji	université
bala	université
vɔ	université
ɖŏ	uriner
hŭ aɖɔ	uriner
gblá mε	avoir besoin duriner
hùn	uriner du
gbò	uriner involontairement
jì	faire lusage
cέkέ	usagé
ganglija	engin très usagé
dŏ kpò	être usagé
dŏ xó	être usagé
aluku cέkέ	très usagé
dŏ xó	être usé
yɛɖonumɛ	le fait duser envers quelquun
zăn ayì blúblú xá	fourberie à légard
ɖŏ yὲ nú mε	envers quelquun
gbìdí nú mε	tous les moyens faire parler quelquun
hù dŏ mε	être à
gbɔjέ	vacances
yĭ azăn	avoir des vacances
xò zĭn	faire du vacarme
gbò àbáhwὲ	vacciner
gbò abɔhwέ	vacciner
gbò hwὲ	vacciner
nyibú	encornée
yì zăn jĭ	vadrouille
xò	vagabonder
tɔxuxo	lagune
adăn	vaillance
klέklὲ	vaille que vaille
nyamanyama	vaille que vaille
ɖù ɖò mε jí	être vainqueur quelquun
mεjiɖuɖè	vainqueur
mεjiɖuɖetɔ	vainqueur
agbăn	faire vaisselle
kpὲn	avoir
àkwέ	avoir
kwέ	avoir
afúyέ	peu
wowunkpálì	qui napprécie pas les choses à leur juste
ɔ	déterminative
gbamὲ	vallée
gbamὲ	vallée fleuve
té	valoir mieux
tè	valoir mieux
awekikε	vanité
yĭ gò	avoir vanité
kὲ awè	être vaniteux
mɛɖéé mɛ	être vaniteux
flé	vanter
víví	vanter
yĭ nugò	vanter
sà xá mε	vanter à quelquun
jlă nŭ dŏ mε	vanter quelque à quelquun
agèvέ	terrestre
hùnkpá	rythme dans groupe que seul linitié sait danser
tεnmε tεnmὲ	varié
sὲn	avoir
sὲn mε	avoir
sὲn sakpatá	avoir
kò	desséchée et noirâtre
gbὲn	terre
sinnugbán	qui contient leau boire
ɖoyaɖoyà	vaste
gblagadaà	vaste
glijaà	vaste
dŏ agbà	être vaste
aganmà	vaudoun
hùn	vaudoun
măsὲ	vaudoun
nyagὲ	vaudoun
yɛhwè	vaudoun
yaócà	vaudoun cangó
yaóyicà	vaudoun cangó
gbàdέ	vaudoun famille xεbyoso
jakata	vaudoun famille xεbyoso
nà	vaudoun fécondité
zunvodún	vaudoun forêt
xɛbyoso	vaudoun foudre
gŭ	vaudoun des forgerons
xwélí	vaudoun domestique
ayĭzàn	vaudoun du marché ouidah
xɛbyoso	vaudoun du tonnerre
nakpókísá	vaudoun enfermé dans
sakpatá	vaudoun originaire région dassa
tolέgbà	vaudoun protecteur
tɔbosí	vaudoun qui va quêter au marché
avĕ	vaudoun
avlekétè	vaudoun des plages
azlì	vaudoun du
akɔvodún	vaudoun
àcígalí	vaudoun protecteur
agὲ	vaudoun qui dévoile les choses secrètes
agbè	vaudoun qui représente mer
atínmέvódún	groupe vaudouns résidant dans arbre
bŏsì	nom vaudoun
hunvε	catégorie vaudoun
jìvòdún	le vaudoun du ciel
jìvòdún	le vaudoun du tonnerre
aklɔnbὲ	nom vaudoun
yakpé	nom du vaudoun dàn
gede	nom du vaudoun région dabomey
dɔvɔ	nom vaudoun dagonlin
adànvέ	sorte vaudoun
àtígalí	sorte vaudoun
avă	sorte vaudoun
avɔsέ	sorte vaudoun
aganmasì	variété vaudoun
ahwansì	variété vaudoun
dàn	variété vaudoun
gŏlò vodún	variété vaudoun
kanlingán vodún	variété vaudoun
aɖò	vaurien
nyibúví	veau
nyibúví é ɖò jó	le veau gras
kεkέ	véhicule avec
agbanhún	véhicule
ayìhún	véhicule terrestre
é kpo	veille
natá kpo sɔ	veille noël
sibigbe kpo	veille du samedi
jɔnu	veillée
mεdóalisá	veillée
zohwĭn	veillée
xwè	faire veillée une fête
xò zăn	faire une veillée
jɔnu	faire une veillée
jɔnu	faire une veillée funèbre
zăn	faire une veillée funèbre
páskwa	veillée pascale
àcéjí	veiller
ɖŏ ayì tè	veiller à
nŭ dŏ wŭ nú mε	veiller à pas faire à quelquun qui agit
nà jɔnu	veiller et au le soir
zăn	veiller une cérémonie vaudoun
ɖŏ ayì tè	veiller
jĭ	veiller
kpé nukún wŭ	veiller
mε jĭ	veiller quelquun
zăn	faire les fonctions veilleur nuit
kεkέ	vélo
jĭ	à vélo
dŏ kεkέ	à vélo
abititì	épais prix
wŭ fún	être velu
kpówɔlɔɖú	une des formes du jeu dajì
axisì	vendeur
axisì	vendeur qui fait les marchés
sà nŭ	vendre
sisa	à vendre
sà kpò	pas vendre
ɖì sà	vendre
sà nŭ nú mε	vendre à crédit à quelquun
jlă nŭ	vendre à criée
ɖè sà	vendre au détail
sà kpεkpὲ	vendre au détail
sà nŭ tété	vendre au détail peu
flí nŭ	vendre au prix coûtant
sà nùtété	vendre menus articles au détail
sà nŭ tété	vendre des petits riens
ɖè sà	vendre peu à peu
sà kpεkpὲ	vendre peu à peu
sà ɖù	vendre consommer directement
sà ɖù	vendre quelque
ɖè nŭ sà	vendre quelque au détail
sà nŭ nú mε	vendre quelque à crédit à quelquun
flí nŭ	vendre bénéfice
sà nùtété	vendre peu
mεxózán	vendredi
bà mε wŭ	quelquun
bà nú mε	quelquun
ɖŏ aɖĭ	être venimeux
wă	venir
wă	faire venir
xwè ɖĕvo	une année à venir
wă gbé	venir
wă kpé	venir à
wă kpé mε	venir à quelquun
wă sò nú mε	venir à rescousse quelquun
dŏ wŭ	venir après
jὲ gŭdò	venir après
wă gbὲ	venir au monde
wă sò nú mε	venir au secours
wă mε	venir auprès quelquun
wă	venir dans
sín	venir dans
wă sín	venir
jὲ	venir devant
sὲ wă	venir devant
gŭdò	venir
tó	venir
nyì ahwàn wă	venir foule
nyì ahwàn wă	venir groupe
nyì ahwàn wă	venir
nyì ahwàn wá	venir
wă nŭ dŏ mε	venir rendre à quelquun
wă nŭ dŏ mε	venir saluer quelquun
wă sù mɛ	venir mettre sous quelquun
wă	venir vers
wă bà mε	venir quelquun
dŏ nú mε	venir voir quelquun que lon pas vu depuis longtemps
fún	faire du
wooó	venant du sahara
kpàn mε	faire première vente
adɔmὲ	ventre
sέlì	le
sέlì	ventre
wă	être venu
sasú	ver et dangereux
kándú	petits vers ronds intestinaux
alaxasà	sorte ver rugueux
domεwĕ	ver
dàn	vers
xomɛdàn	vers
agbà	véranda
dŏ	vérifier
nùgbónúgbó	véritablement
ɖù yà	être vermoulu
àglúzasú	verrat
aglúza	verrat
sέxlò	verrou
jεgùn	verrue
leέ	vers précis
gbadanu	vers le soir
hwè jὲ tókpá	vers les heures laprès
hwè jὲ tókpá	midi
hùzú	être
takwέ súsú	versement limpôt
kinkɔn	métal
dé mὲ	dans
dŏ é mὲ	dans
bà sìn	leau terre hommage aux ancêtres
bà sìn nyì àyĭ	leau terre hommage aux ancêtres
bà sìn	leau terre une
bà sìn nyàyĭ	leau terre une hommage aux ancêtres
bà sìn nyì àyĭ	leau terre une hommage aux ancêtres
wŭn dŏ zò	lencens du
kɔn hùn	le humain
dáyĭ	terre
dŏ ayĭ	terre
nyì ayĭ	terre
nŭ dŏ mὲ	quelque dans
fεὲn	sapplique à couleur verte
nεgbexú	vertèbre
nukúnmέgbázĭn	vertige
nukún	avoir des vertiges
wunɖáwúnɖá ɖá mε	avoir des vertiges
nukún gbà zĭn	avoir le vertige
jijɔ ɖagbe	vertu
jujɔ ɖagbe	vertu
ɖŏ tamὲ	vertu
awù	vêtement
dowù	vêtement dessous
nùwámεwù	vêtement deuil
bawùn	vêtement femme avec des manches très amples
dŏ awù	vêtir
asúkúsì	veuf
văblε	veuf
didε	viande coriace
mŭ	viande crue
nyibulán	viande boeuf
làn	viande porc
hunɖè	viande donnée cadeau à celui qui tué lanimal
hwesalàn	viande du marché
didε	viande élastique
gannúmέlàn	viande boîte
gannúmέlàn	viande
mŭ	viande fraîche
susɔ	viande frite
hihi	viande fumée
hihi	viande grillée
mimε	viande grillée
hizahízá	viande rôtie
mimε	viande rôtie
susɔ	viande rôtie
jεmεlàn	viande salée
landójὲ	viande salée
xíyáxíyá	viande séchée
gblĕ	vicier
mε gbigblé	vicieux
zùn mε	être vicieux
ahwanjíɖúɖè	victoire
togbibga	victoire
dŏ tófwé	être vide
gblŏlŏ	être vide
kúgbègbεgbè	à à
ɖò gbὲ dĕ	cette
gbεmε fí	cette
ɖŏ gbὲ	être
gbὲ	être
ɖò ɖokpó jí	être entre et
gbὲ	plénitude
gbὲ mavɔmavɔ	éternelle
gbὲ funyafunya	loi
mεkpikpò	vieillard
mεkpukpo	vieillard
mεxó	vieillard
nyaɖaxó	vieillard
nyaxóxó	vieillard
degenɔ kpikpò	vieillard
mεxóxó	vieillard
degenɔ kpikpò	vieillard décrépit
kpò nyɔxó	être vieille
nyɔɖaxóví	être vieille
kpikpò	vieillesse
kpukpò	vieillesse
mεxó	vieillesse
ɖɔxwí	qualifie une boisson qui vieilli
kpò	vieillir
mεɖalɔji	vierge
fínnífínní	vierge jeune homme ou une jeune fille
ɖò jí	être vierge
ɖò alɔjí	être vierge
ɖò sέ gbè jĭ	être vierge
kpikpò	vieux
kpukpò	vieux
kújέ	vieux
nyaxóxó	vieux
kpò	être vieux
degenɔ kpikpò	une vieille personne
nyɔɖaxó	vieille femme
nyɔxó	vieille femme
ganglija	vieux clou
agbawungbalokè	vieux du
aglijà	vieux matériaux terre ruine
ɖéɖéɖé	vif
gbεɖè	vif
zìn ɖò nukún	avoir les yeux vifs
zìn	être vif
azingblέntέn	qualifie enfant vif
ɖŏ ayì tè	être
tè	être vigueur
kpò ɖò tè	être vigueur
bè	vigueur au rachitisme
nylă kàn	vilain
nylànylá	très vilain
dàká	vilenie
toxomὲ	dans le
glegbεtá	groupement villageois
ajàlá	nom plusieurs villages
domὲ	nom du ahémé
dèkánmὲ	nom
jεgbají	proche ouidah
tomεnù	villageois
aladà	historique lancien dahomey
adànhúnsá	nom donné à dalada
ajăhɔnmὲ	une
hwεgbó	au nord dalada
dĕtàn	vin du palmier à huile
sélítán	vin du palmier dattier
bà	être vindicatif
ɖokpó	vingtcinq francs
ɖŏ adăn wŭ	violemment
gblawùn	violemment
ɖò wŭ	violemment
jɔwùn	violemment
ɖŏ adăn wŭ	avec
kàn xá mε	faire à une femme
nŭ	violenter les choses
dă alὲ mε wŭ	le pacte damitié
dà lὲ mε wŭ	le pacte damitié
dŏ asá sέn	interdit
kàn xá mε	une femme
tlέn mε	une personne
amasúkpwὲ	vipère
amakpwὲ	vipère à corne
amàsέ	vipère très
sέgbéjí	virginité
kàn	faire perdre virginité à une jeune fille
ɖŏ	le membre viril
ɖŏ jĭ	viser
dáán	viser
kpé tú	viser avec
kpé tú làn	viser le gibier
gaàn	visiblement
kloloò	visiblement
kpé nŭ	avoir une
bà jlὲ	chez quelquun
yì bà mε	chez quelquun
dŏ	rendre
yì jŏ gbé	rendre
yì nŭ dŏ mε	rendre à quelquun
dŏ mεɖé	quelquun
jŏ	visiteur invité
bà mε	avoir visiteur
blè	vite
glíwún	vite
klaxla	vite
kplákplá	vite
kpláwún	vite
léwúnléwún	vite
tɔ kokló	vite
ɖì blemú	au vite
yă wŭ	faire vite
gbligblì	à toute vitesse
gbεɖè	vivant
ɖŏ gbὲ	être vivant
gbεɖegbεɖè	vivant
hwεnwùn	vivement
nyέwún	vivement
dŏ gbὲ	vivre
gbεzinzan	manière vivre
wà nŭ kwíjí kwíjí	vivre dans débauche
ayì jὲ ayĭ	vivre dans paix
ayì jὲ ayĭ	vivre dans sécurité
jὲ	vivre bonne
yàyá	vivre
jὲ	vivre
vò	vivre inoccupé
jì	vivre longtemps
àkpá	voeu
akpádídó	voeu
dŏ akpá	faire voeu
ɖíè	voici
nyaví	cet enfant que voici
alì	voie
sunví wɔɖɔɖɔ	voie lactée
ɖíè	voilà
énέ	voilà
nέ	voilà
kpétó	veux voilà
gbεgbὲ	veux voilà
gbεgbεgbὲ	veux voilà
mε ɖé nέ	voilà
nù é wŭ	voilà pourquoi
nù é wútú	voilà pourquoi
nù é wùtù wè	voilà pourquoi
kpεὲn	voilé
avɔ	voiler tête
mimɔ	voir
mumɔ	voir
nù	voir
bà	voir
bà mε kpò	voir quelquun et pas le trouver
nukún nŭ	voir clair
nukúnnú	voir clair
gbà zĭn	voir
nukún gbà zĭn	voir
nŭ	voir une extraordinaire
xwékpànù	les voisins
gbè	voix
gbe lómílómí	voix
gbe lómílómí	voix limpide
gbe lómílómí	voix mélodieuse
hangbè	voix
gbè lílélílé	voix très
jajò	voler
jὲ ajò	voler
fìn bà	voler des objets que lon cherchés
fìn wŭn	voler puisant
fìn nŭ dŏ mε	voler quelque à quelquun
fìn nŭ ɖù	voler quelque et le
jà ajò dŏ mε	voler quelquun
jὲ ajò dŏ mε	voler quelquun
fìn gbă	voler pagne vêtir
fìn nŭ ɖù	voler une
ajogbέ	voleurs
bàkpé	qualificatif ajoute au voleur
axánsúnxó	qualificatif que lon donne à voleur professionnel
awùngósú	voleur fieffé
avɔsέ	voleur renommé
kpó ayi kpó	volontiers
fεε	très volontiers
kloklo	volumineux
jŏ	vomir
slú adanvέ	vomir
vì adanvέ	vomir
gblé	être vorace
wlă nŭ ɖù	être vorace
wĕmà nú mɛ	quelquun
mitɔn	le vôtre
mitɔn lέ	les vôtres
dŏ mεɖé vodún mὲ	vouer quelquun au vaudoun
ɖò mε ɖóɖó	faire que lon veut
tὲ	pas vouloir donner
asú	vouloir époux
gbò mε	vouloir à prix
gbò mε	vouloir absolument
nŭ	vouloir faire une qui dépasse âge
dŏ nukúnkὲn	vouloir obtenir au delà ses mérites
hwlέn kàn xá mε	vouloir une femme
yì nú mɛ	apporter soutien à quelquun
yì nú mɛ	traiter une affaire
dŏ yì	à moto
yì tomὲ	à
dăn hùn	à travers
dŏ kεkέ yi tomὲ	à vélo
dŏ yì	à vélomoteur
dŏ xujihún yi tomὲ	mer
mὲ	hamac
dŏ hŭn	ou voiture
gbèvún	voyou
jὲ aglăjà	faire le voyou
aɖò	nom donné voyou
ayakatayajà	vrac
paákpaá	le vrai
tankpikpi	une histoire vraie
nùgbónúgbó	vraiment
ganaganà	au vu et au su le monde
lixò	au vue
ɖò ɖokpó jí	avoir le même vue
nukún nŭ	avoir le sens vue
gbé	vue
kpaà	vulgaire
hwĭ	yatagan sorte yatagan
flimítín	ylang
bàbă ayɔnù	yoruba
hunjεdónùjí	zèle
nukúnkpédómεwú	zèle
myă nukún nú	être zélé
fún sà	zigzaguer
tɔmyɔ	zona
đo hwenu mawu ɖó	au dieu créa les cieux et terre
ayǐkúngban ɖo kpowun bɔ nǔ ɖěbǔ ɖo jǐ tɔn ǎ zǐnflú xu ayǐjɛ bɔ yɛ mawu tɔn ɖo yiyi wɛ ɖo	terre était informe et vide il avait des ténèbres à labîme et lesprit dieu mouvait audessus des eaux
mawu ɖɔ wěziza ní tíin bɔ wěziza tíin	dieu que lumière soit et lumière
mawu mɔ ɖɔ wěziza nǔ ɖagbe wɛ ɖe wěziza ɖó vo nú ablu	dieu vit que lumière était bonne et dieu sépara lumière davec les ténèbres
é wěziza ɖɔ kéze bó ablu ɖɔ zǎn zǎn kú bɔ ayǐ azǎn nukɔntɔn	dieu appela lumière jour et il appela les ténèbres nuit ainsi il eut soir et il eut le jour
mawu ɖɔ tɛnmɛ ɖaxó ɖé ní tíin bó má nú ɖokpó ná ɖo jǐnukúnsin nú ɖokpó ná ɖo ayǐkúngban jí	dieu quil une étendue entre les eaux et quelle sépare les eaux davec les eaux
nǔ nyí nǔgbó mawu bló tɛnmɛ bó má ɖó ɖokpó ɖo bɔ ɖokpó ɖo	et dieu létendue et il sépara les eaux qui sont audessous létendue davec les eaux qui sont audessus létendue et cela ainsi
é tɛnmɛ ɖaxó ɖɔ jǐnukúnsin zǎn kú bɔ ayǐ azǎn	dieu appela létendue ciel ainsi il eut soir et il eut le jour
mawu ɖɔ ɖo ní kplé cí fí ɖokpó bónú fí xúxú ní jɛ wě bɔ nǔ nyí nǔgbó	dieu que les eaux qui sont audessous du ciel rassemblent seul et que le paraisse et cela ainsi
bɔ é fí xúxú ɖɔ ayǐkúngban fí kplé cí ɖɔ xu mawu mɔ ɖɔ nǔ ɖagbe wɛ	dieu appela le terre et il appela lamas des eaux mers dieu vit que cela était
gúdo mawu ɖɔ gběhan kpó atín kpó ní wú kpé ayǐkúngban bǐ jí yě ní ná kwín yětɔn yětɔn bó ná yětɔn yětɔn bɔ nǔ nyǐ nǔgbó	puis dieu que terre produise lherbe portant des arbres fruitiers donnant du selon leur espèce et ayant eux leur terre et cela ainsi
gběhan wú ɖo ayǐkúngban jí gběhan tɛnmɛ tɛnmɛ wú atín tɛnmɛ tɛnmɛ wú bɔ yě ná yětɔn yětɔn bó ná kwín yětɔn yětɔn mawu mɔ ɖɔ nǔ ɖagbe wɛ	terre produisit lherbe portant selon espèce et des arbres donnant du et ayant eux leur selon leur espèce dieu vit que cela était
zǎn kú bɔ ayǐ azǎn	ainsi il eut soir et il eut le troisième jour
mawu ɖɔ nǔ ná wěziza ní tíin gbɔn fí bǐ ɖo jǐnukúnsin bó ɖe kéze ɖó vo nú zǎn yě ná nyí wuntun ɖé bɔ è nǎ xwédo dó tunwun hwenu azǎn kpódó xwe kpó	dieu quil des luminaires dans létendue du ciel séparer le jour davec nuit que soient des signes marquer les époques les et les années
yě ná nɔ jǐnukúnsin bó ná ná wěziza dó ayǐkúngban jí bɔ nǔ nyí nǔgbó	et quils servent luminaires dans létendue du ciel éclairer terre et cela ainsi
mawu bló nǔ ná ná wěziza ɖaxó wɛ nyí hwe ná kpa acɛ nú kéze kpɛví wɛ nyí bó ná kpa acɛ nú zǎn é bló sunví	dieu les deux grands luminaires le présider au jour et le présider à nuit il aussi les étoiles
mawu yě ɖó jǐnukúnsin bónú yě ná ná wěziza dó ayǐkúngban jí	dieu les plaça dans létendue du ciel éclairer terre
yě ná kpa acɛ nú kéze bó ná kpa acɛ nú zǎn bó ná ɖe wěziza ɖó vo nú zǐnflú	présider au jour et à nuit et séparer lumière davec les ténèbres dieu vit que cela était
zǎn kú bɔ ayǐ azǎn	ainsi il eut soir et il eut le quatrième jour
mawu ɖɔ kanlin tɛnmɛ tɛnmɛ ní tɔ mɛ winnini xɛ ní tíin bó zɔn gbɔn jɔhɔn mɛ	dieu que les eaux produisent abondance des animaux vivants et que des oiseaux terre vers létendue du ciel
nǔgbó mawu ɖǒ xumɛkanlin ɖaxó ɖaxó kpódó kanlin tɛnmɛ tɛnmɛ nɔ tɔ bǐ kpó bɔ yě kpé tɔ mɛ winnini é bló xɛ tɛnmɛ tɛnmɛ bɔ mawu mɔ ɖɔ nǔ ɖagbe wɛ	dieu créa les grands poissons et tous les animaux vivants qui meuvent et que les eaux produisirent abondance selon leur espèce il créa aussi oiseau ailé selon espèce dieu vit que cela était
mawu xo ɖɛ dó yě jí bó ɖɔ ji gba kún bó kpé tɔ mɛ bónú xɛ ní gba kún kpé gbɛ mɛ	dieu les bénit disant soyez féconds multipliez et remplissez les eaux des mers et que les oiseaux multiplient terre
zǎn kú bɔ ayǐ azǎn	ainsi il eut soir et il eut le cinquième jour
mawu ɖɔ ayǐkúngban ní ná xwé kanlin tɛnmɛ tɛnmɛ gběkanlin tɛnmɛ tɛnmɛ kpó kanlin tɛnmɛ tɛnmɛ nɔ sá kpó bɔ nǔ nyí nǔgbó	dieu que terre produise des animaux vivants selon leur espèce du bétail des reptiles et des animaux terrestres selon leur espèce et cela ainsi
nǔgbó mawu bló gběkanlin tɛnmɛ tɛnmɛ xwé gbe kanlin tɛnmɛ tɛnmɛ kpó kanlin tɛnmɛ tɛnmɛ nɔ sá kpó bó mɔ ɖɔ nǔ ɖagbe wɛ	dieu les animaux terre selon leur espèce le bétail selon espèce et tous les reptiles terre selon leur espèce dieu vit que cela était
gúdo mawu ɖɔ mǐ ní bló ɖó mǐ ɖésúnɔ sín mɛ nú yě ní cí mǐ ɖésúnɔ ɖɔhun yě ní kpa acɛ nú hweví bó kpa acɛ nú xɛ bó kpa acɛ nú xwé gbe kanlin kanlin nɔ sá yě ní kpa acɛ nú ayǐkúngban bǐ	puis dieu faisons lhomme à notre selon notre ressemblance et quil les poissons mer les oiseaux du ciel le bétail toute terre et tous les reptiles qui rampent terre
mawu ɖó ɖó é ɖésúnɔ tɔn mɛ é ɖó é ɖésúnɔ tɔn ɖɔhun é ɖó súnnu kpódó kpó	dieu créa lhomme à il le créa à limage dieu il créa lhomme et femme
gúdo é xo ɖɛ dó yě jí bó ɖɔ ji gba kún bó kpé ayǐkúngban jí bó ɛ ɖó acɛ mitɔn hweví ɖó acɛ mitɔn bó xɛ ɖó acɛ mitɔn bó kanlin ɖo ayǐkúngban jí bǐ ɖó acɛ mitɔn	dieu les bénit et dieu leur soyez féconds multipliez remplissez terre et lassujettissez et dominez les poissons mer les oiseaux du ciel et qui meut terre
é ɖɔ nú yě ɖɔ gběhan ɖo ayǐkúngban jí bó ɖó kwín ná bǐ bó ná atín ɖo ayǐkúngban jí bó bɔ yětɔn ɖó kwín bǐ yě ná nyí nǔɖuɖu mitɔn	et dieu voici je vous donne toute herbe portant et qui est à toute terre et arbre ayant lui du darbre et portant votre nourriture
ɖokpó ná bɔ yě ná nyí nǔɖuɖu nú kanlin ɖo ayǐkúngban jí bǐ yě ná nyí nǔɖuɖu nú xɛ bǐ yě ná nyí nǔɖuɖu nú kanlin nɔ sá bǐ yě ná nyí nǔɖuɖu nú nǔ ɖo gbɛ bǐ bɔ nǔ nyí nǔgbó	et à terre à oiseau du ciel et à qui meut terre ayant soi je donne toute herbe verte nourriture et cela ainsi
mawu mɔ ɖɔ nǔ émí bló bǐ nǔ ɖagbe wɛ yě nyí tawun zǎn kú bɔ ayǐ azǎn	dieu vit quil avait fait et voici cela était très ainsi il eut soir et il eut le sixième jour
gbɛmɛ ɔ mɛ wɛ nɔ	dans fais quelque ils avec
nyi etɛ	quoi cela
nɔvi nyɔnuvi atɔngɔ atɔn nyɛ mɛ wɛ ɖe	sœur une fille troisième personne qui vient après moi
bɔ xo jɛ asi tɔn	est tombée enceinte
xo ɖe asi tɔn ja vi ji gbe azan nabiɖe	il trois voulu accoucher
bɔ ylɔ ɖɔ ɖɔ mɔ wɛ kwɛ ɖe kun ɖo emi	appelé ainsi pas dargent
bɔ ɖɔ ok	et jai
bɛ wezun ɔ kwɛ ɖe ɖo wezun yi gɔn tɔn	quand je suis mis à courir je suis venu chercher largent et jai couru chez
ylɛ katie wɛ nɔ nɔ	je appelée au quartier où habite
tɛ tuun katie xwe ɖe gbe nɔ nɔ ă	je connais pas vraiment le quartier et maison où habite
ɖo ɖo komisaria ɖe nukɔn	et sest fixé devant le
yi mɔ ɛ	et je suis venu voir
mɔ ɛ ɔ adɔgo tɔn bi	jai vu que ventre est totalement descendu
bɔ mɔ ɛ ɔ ɖɔ je jan ji vi wɛ	vois quelle
bɔ ɖɔ	et jai
ɖe nɛ adɔgo ɔ lɛ yi bi gbɔn nɛ aji bɔ ɖɔ jre ke	ventre est descendu comme ça et que
emi azan tɔn emi lɛ kɔ	proposé revenir dans trois
bɔ ɖɔ hwɛ jan ji vi wɛ	et je lui
bɔ ɖɔ xo ɖo finɛ	et parlé là
bɔ nyɛ xwe yi gbe ze caki atɔɔn	et lorsque voulu partir je lui remis
bɔ yi	et je suis parti
yi ɔ ayihɔntɔn gbe jɛn telefon sone kakakaka ylɔ ɔ	quand je suis parti seulement le lendemain le téléphone sonné jusquà parlé
nyɛ tɛ tuun ɖaxo bi ɔ wɛ ɖo ylɔ wɛ	je savais même pas que grande sœur qui appelé
bɔ yi ɔ kpɔn ji ɔ mɔ ɖɔ jre ke ɖo ylɔ wɛ bɔ ylɔ	et quand je suis allé je suis venu voir qui appelé et je les rappelés
bɔ ɖɔ jre ke emi ɖo dotoxwe ɖo maternite	et ils mont quils sont à lhôpital maternité
ɖe yi dotoxwe ɖokpo ɖo saintjean	quils sont partis dans hôpital à saintjean
yi dotoxwe ɔ sagefemme ɖe ɖo finɛ lɛ ɔ	quand ils sont allés à lhôpital les sagesfemmes qui sont là
kpɔn adɔgo ɔ bɔ ɖɔ nɛ adɔgo ɔ ci yovozɛn ɖɔhun nɛ aji ɖe	elles ont regrdé le ventre jusquà le ventre ressemble à une
kun ji vi ɔ ɖo ɖe	peut pas accoucher ici
wema ɖo ji ɖɔ je maternite	et elles leur ont fait papier aillent à maternité
maternite ɔ wɛ ɖe ɖo	ils sont à maternité
bɔ ze ze yi maternite ɔ etɛ ganxixo	amené à maternité et ça fait même pas deux heures
vi jɛn ji	accouché seulement enfant
ji vi ɔ ji sunnu vi ɖokpo	accouché enfant accouché garçon
ɖe xwe dotoxwe ɔ hɛn kwɛ ɖebu	lorsquelle allait à lhôpital navait pas
ɖaxo wɛ hɛn caki fɔtɔn ɖo alɔ mɛ	grande sœur avait francs
bɔ amasin ɖe wlan ɔ kpo ɖo kwɛ ɖe su ɖo caisse kpo enɛ lɛ kpo bi ɔ	et des médicaments quils ont prescrits est entièrement servi à caisse
eyɛ su cobɔ asu ɔ	qui payé avant que mari vienne
asu ɔ caki atɔɔn jɛn ze	le mari est venu et remis que
bɔ lɛ yi bɔ ɖɔ emi	et il est reparti disant quil va revenir
yi bɔ lɛ lɛ kɔ ze kwɛ ɖe su ɔ	il est parti il est revenu et il donné largent que sœur dépensé
ze	il le lui remis
donk ɔ ɖɔ xɔ	et maintenant ils ont quon va lui donner une chambre
mais sɔ ylɔ nɔ ɔ	mais hier jai appelé maman
nɔ ɖɔ jre ke ɖo	mais mère rendue et est rentrée à maison
nyɛ su zaanɖe ɔ	moimême peu temps maintenant
ɖisa yi kpɔn ɖɔ nugbo aji yi kpɔn ɖo xwe ɔ gbe bɔ yi kpɔn vi ɔ	je peux voir est vraiment à maison les voir et venir voir
burkina faso ɖe yi ɔ jɛ ɔ mɛ ɔ	burkina faso quand suis allé quand je suis arrivé dans le pays
ɔ mɛ kwiji	le pays est
ɔ mɛ kwiji azɔ azɔ	le pays est le et le
ðɔnkpɛvu ɖe ɖo dɔn lɛ ɖesu ɖo mɔ azɔ ɖo wiwa ă	même les jeunes qui sont làbas ils trouvent pas à faire
ɔ mɛ kwiji bɔ yɔkpɔvu lɛ bi sese nɔ ɖo azɔ wɛ nɔ ɖo siga wɛ	le pays est et tous les petits totalité ils ils fument
nyi ɖe elɔ nɔ ɖo xɛsi ɖi mɛ wɛ ɔ	pas comme ici où ils ont peur des grands
dɔn nyi mɔ ă	làbas pas ça
mɔ vi kpodo nɔ kpo ɔ mɔ vɛ ɖɔ kpodo nɔvi kpo wɛ	vois fille avec maman croire que grande sœur et sœur
mɛ bi mɛɛ ɔ mɛ ɔ kwiji	le mais le pays est
amɔ biveti wɛ gbɔn bi bɔ mɛ bi sese nɔ ɖo ahan wɛ nyi gbɛ	mais voir des buvettes partout et le monde boit ils aiment trop fête
ðo yedɛ kwɛ yedɛtɔn ɔ gbɛ wɛ nɔ ɖu	eux leur ils aiment faire fête
ɖo ɖu gbɛ wɛ nyi yedɛ	dois fêter eux ils sont comme ça
yi ɔ mɛ ɔ mɛ gɔn yi ɔ	quand je suis parti dans le pays personne chez qui je suis allé
kwilar lɛ ɖɔ je emi ja lɛ yi	cular il quil veut partir au
ðe lɛ emi yi ɔ bɔ ɖɔ	comme que veux partir au jai ok
ja yi bɔ ɖɔ ɛɛn bɔ ɖɔ nyɔ	veux partir au et il oui et jai
nyɛ xwe yi	moi je peux pas suivre au
finɛ nyɛ ɖo lɛ kɔ ɖe bɔ eyɛ yi ɔ	là que je suis retourné et lui est parti au
finɛ nɔ finɛ ɖe yi ɔ	là je suis resté là lui il est parti
kwɛ	il donné largent
bɔ hun	et jai pris le
xwe	au pays
mɛɛ byɔ ɔ mɛ ɔ	mais rentres dans le pays
ɔ mɛ ɔ nyɔnnu etɔn lɛ sunnu yetɔn lɛ nɔ mɛ	dans le pays leurs femmes leurs hommes ils sont propres
nɔ lɛ wu nɔ mɛ mɛ wu beninois lɛ	ils lavent et sont propres que les béninois
mɛɛ ɔ mɛ ɖesu ɔ kwiji	mais le pays
byɔ finɛ ɔ ɖo ɖo kwɛ ă	et rentres là dois nas pas largent
eo activite ɖebu ɖo finɛ ă	peux pas faire dactivité
aktivite towe ɖebu kwɛ jɛ	activité rien avec feras
ɖo kwɛ ɔ activite towe marche	activité va
byɔ ɔ mɛ ɔ ibo lɛ ɛ wɛ sukpɔ	rentres dans le pays il plein nigerians
ibo lɛ wɛ ɖo kwɛ nɔ yetɔn	les ibo qui ont largent ils leur
gbɔn internet	internet
ɖo kwɛ yetɔn ganji	ils ont beaucoup dargent
yeedɛɛ zɔn bɔ	deux
mɔ ɖɔ dɛ ɖesu mɛ mɛɛ ɔ mɛ ɖesu lɛ ɔ	verras queuxmêmes sont propres mais les mêmes du pays
eo nuɖe ɖo finɛ ă	il ny rien là
ɖɔ xo ɖo adagbigbo sunnu lɛ tɔn ji	allons parler circoncision des hommes
adagbigbo ɔ sunnu lɛ tɔn nuɖe wɛ nyi bɔ ɖo	que circoncision des hommes une qui est qui
ɖo taji sunnu ɖokpo ɖokpo	est primordiale les
adagbigbo ɔ	circoncision
gbɛtɔ sunnu ɖokpo jɔ ɖo gbo ada	individu mâle qui naît faire circoncision
bɔ mɔ ɖɔ je mɛ ɖe ke mɛ bi nɔ gbo ă	cependant remarquons que des que pas le monde qui
mɛ ɖe lɛ ɔ nɔ gbo ɖo yɔkpɔvu	certains le quand ils sont jeunes
mɛ ɖe lɛ nɔ gbo ɖo mɛxo mɛ	coupent à âge avancé
mɛxo tawun wɛ nɔ ɖo	ils sont vraiment des adultes ils sont déjà à âge
xwe ɔ nɔ sɛ yi kpɛɖe	à âge déjà peu éloigné
cobɔ nɔ gbo	mais ils les coupent
bɔ nɔ wuvɛ enɛ ɔ	et ils sentent douleur
amɔ nyɛ mɔ ɖɔ je mɛ ɖe que gbo ada sunnu ɔ	mais je vois convienne circoncisent les hommes
hɛɛn nɔ xlɛ sunnu ganji	hé ils montrent homme
nɔ ɖɔ enɛ sunnu sunnu sunnu ɖie	et cet homme sest rapproché femme à quelle heure
ɖe	il est
bɔ vodun ɔ vodun vodun vodun ɔ jɛ gbe ɖo finɛ ɔ nɔ mɔ ɖɔ ɛɛn ganji	et le vodou qui surgit là voit que oui
nyi jacɔ	lui sied
nyɛ mɔ ɖɔ je mɛ ɖe ke adagbigbo ɔ	et moi donc je vois que circoncision
ɖo nɔ kpɔn nɔ gbo vi mĭtɔn lɛ ɖo yɔkpɔvu mɛ adagbigbo sunnu tɔn mɛ ɔ	devons attendre circoncire nos enfants âge
gbo ɖo yɔkpɔvu mɛ	les couperons dans
hwenu wuvɛ ɔ nɔ mɔ ɖe kpo	là douleur va va ainsi diminuer
ɖo nyɛ mɛ ɖe bɔ ɖɔ xo ɔ	que certains disent maintenant
ɖo xwe yi dibla wɛ ayizɛn cobɔ ɖo ɔ	déjà presque ans quand circoncis
wuvɛ enɛ ɔ bɔ ci ayi mɛ	senti une grande douleur et resté dans esprit
bɔ mɔ ɖɔ ɖagbe ɖe wɛ	et je trouve que une bonne
nyɔnuvi ɖe lɛ ɖo kartie	certaines jeunes femmes dans quartier
xwe ɖe nɔ mɔ cobɔ nɔ mɔ xwe ɔ	quon trouve dans une maison avant mienne
bɔ mɛ bi hwii	elles sont toutes nombreuses
mɛ ɖebu sɔ yi yɔkpɔvu su	elles sont des enfants elles ont déjà grandi
donk su	donc elles sont déjà grandes
bɔ su normaleman	donc elles vont mari normalement
mais ɖo finɛ kpo nɔ ɖɔ mɛ ɖevo xo	mais elles sont là seulement commérer les autres
hɛn eɖee gble tawun ɔ	qui constitue leur grande
ɖo dindin wɛ ɔ	et passes devant elles
mɔ xo ɖe bɔ ɖɔ ɖo towe jɛn wɛ	elles trouveront une histoire parler précisément
bɔ nɔ yi nɔ mɛjɔmɛ	et elles et comme les importants
nyi mɛ ɖe bɔ mɛ ɖe nɔ kpɔn ji sɔ mɔ ɖe	sont des personnes et personne ainsi à elles
mɛme sunnu ɖe nɔ gɔn lɛ ɔ	même les hommes qui viennent chez elles
sunnu ɖe ɖo nuɖe lɛ nɔ ci gɔn	des hommes qui rien à faire et qui viennent séjourner chez elles
bɔ nɔ kple ɖo finɛ	et elles rassemblent là
mɛɖe ɔ ɖɔ mɛ ɔ xo	et maintenant est là elles parleront personne
mɛ ɔ	et les ont entendu
bɔ byɔ nɔ yi jlɛ	et demandent des explications elles cherchent querelle
bɔ nɔ kple nɔ zun mɛ ɔ kabi xo xa mɛ ɔ	et elles groupent personne ou elles vont bagarrer avec les
ɖokpo ɖe tuun bɔ nɔ	seule savent leur faire
sinɔn fɛti mɛ bi ɖo finɛ ɔ	sinon fait sont toutes des personnes qui résident là maintenant
mɛ ɖebu yi asu xwe jɛ	aucune déjà partie dans maison homme jusquà présent
ɖo kutɔnu ɔ ɖuɖo mɛ	cotonou
yovo lɛ nɔ ylɔ ɖɔ	les yovos appellent cela
sukpɔ tawun	il beaucoup
wɛzɔn bɔ yɔyɔ emi ze ɖo benɛn ɔ	pourquoi le nouveau président élu au bénin
nɔ ylɔ ɛ ɖɔ yayi boni	il président yayi boni
ɖo alɔ ɖo mɔnkɔntɔn ji wɛ ɖuɖo mɛ ɔ	il est mettre qui constitue
wɛ nyi etɛ jɛn wema ɖo fiɖe ɔ	quoi ça consiste veux faire papier quelque maintenant
ɖo wema towe lɛ	et déposer tes papiers
nɔ yi wema ɔ ɔ sɔgbe ganji le co	les papiers ceuxci devraient être prêts
ɖɔ ɖɔ jre kun sɔgbe	ils vont que pas prêt
bɔ yi ɖo yiyi wɛ ɖo wiwa wɛ	et faire les allersretours
bɔ zan kwɛ nebiɖe ze	que dépenses une certaine somme que apportée
kwɛ ɖe ɖo wema ji ɔ trolo nɔ mɛ	apporté le papier ils personne
enɛ ɔ nyila tawun ɖo bɛnɛn	très mauvais le bénin
gbe ja passeport gbe ja	que veux faire le passeport que veux faire
ze kwɛ ɖe wema ji	mets pas dessus le papier
eɖɛ lɔ ɖesu nɔ ɖɔ	euxmêmes ils disent
ze hwan ɖo wema ji jɔhɔn ze wema	mets pas morceau le papier le
wɛ yeɖɛ ɖo ze hwan ɖo wema ji hwan ɔ ɖo kwɛ ɔ nyi wɛ	mettre le papier veut que donnes
ɖo ze kwɛ ɖe ɖo wema ɔ ji cobɔ wema ɔ wu tɔn	dois mettre le papier que les formalités soient faites
mɔ ɖokpo ɔ ɖo militɛ lɛ kponɔ lɛ ɖesu mɛ	même les militaires les policiers eux aussi
kɛkɛ kun wɛ brule	roules moto brûles le
abi hɛn agban ɖe abi ɖo	ou beaucoup bagages ou
ɖo yiyi wɛ	et passes
yi kwɛ caki ɖokpo caki	ils prennent
kpɔn wewe wɛ ɖo ɖɔ hwɛ yi	et ils laissent partir
enɛ lɛ byɔ nɔ ɖo ɔ dɔn ɖo dɔn gudo wɛ	ça qui laisse le pays arrière
bɔ miɖɛ ɖesu tuun	et nousmêmes pas compte
yayi boni ɔ enɛ lɛ bi ɛ jan kun enɛ lɛ bi	et yayi boni est venu maintenant toutes ces choses il veut mettre
dawe ɔ ɖo azɔn wɛ tawun ɖo ɔ wu	mais il travaille correctement le pays
azan nabiɖe nɔ nyi aeroport ali ɔ ji dɔn	fois passée parti voie
aeroport ali ɔ ɖo bi	ils ont réparé voie
bɔ gba xwe ɖagbeɖagbe ɖe lɛ ɖo aeroport gudo finɛ ɖo xo ɔ bɔ	et ils ont construit belles maisons derrière au mer
eo mɔ ɖɔ kutɔnu ɔ	vraiment vois cela que cotonou changé
mɛ ku lɛ ɔ	mais les qui sont morts
yeɖɛ jɛ sɔ mɔ elɔ lɛ	sont eux qui peuvent voir ça là
wɛzɔn bɔ ku ɔ nyi ɖagbe ɖe	pourquoi pas une bonne
ɖo gbɛ jɛn wɛ ɔ nɔ mɔ	voir
fɔn ganji à	réveillé
ɖo kɛɖɛ à	bonne santé
enɛ ɖɔ emi danxomɛ mitɔn mɛ	oui que viens au dahomey le ventre du dans notre pays
xwebaja mɛ	dans le pays du xwebaja
xwebaja mɛ ɔ mɔ jonɔ ɔ nɔ yi ganji	au pays du xwebaja trouvons le recevons très
mɛ yovo anyŭ wewenɔ lɛ	vous les blancs à peau
mitɔn mɛ ɔ yi ɖo ɔ	vous venez dans notre pays vous recevoir parce
mitɔn lɛ mitɔn lɛ grandpapa	nos grands rois nos ancêtres les
wɛ sɔ mitɔn sɔ syan ayi kpɛɖe	déjà eux qui ont fondé à notre pays
đe nɔ bɔ nyɔ ɔ wɛ sɔ ɖo	ils fondé correctement tel être
mɔ ɖo mɔ jɛ mɛ hun	estce que vois que je suis donc
ɖɔ miɖee ɖo agbomey ɔ ɖɔ wɛ ylɔ mitɔn lɛ wɛ xo mɛ	est que parlant nos grands rois qui ont dans le ventre
aɖɔgò mɛ lɛ sɔ xwe ɖo ɖɔ kun nɔ mɔ nukun jɛ aɖɔgo mɛ	dans les ils les ont couvert avec une calebasse disant voit pas qui dans notre ventre
ɖɔ yeɖee nɔ ɖɔ xwegbaja kasudo nɔ hun kpɔn	raconte à propos du xwegbaja kasudo peut ouvrir calebasse
mɔ nukun jɛ mɛ hun mitɔn mɛ ɖo ɔ ɖagbe ɖo	comme ça compris donc que dans votre pays ici il le
akwɛ ɖo	il
bi ɖo	il
mɔ miɖɛ lɛ tɔn lɛ ɔ ɖo kwɛ hu	mais dans votre pays il
ɖo mɔ jɛ mɛ	estce que compris
hun ɛ emi ɔ	donc mais là où vous êtes venus ici maintenant
cɛ emi nɔ tɔn kpo sɔ dɔn	je vous remercie venir làbas très
nɔ ɔ cɛ	et parce que vous venez ici je vous remercie
bɔ bi ɖo ganji lɛ vɔ yi ganji	et vous venez tous ici vous viendrez comme il convient et vous repartirez comme il convient
bɔ ɖagbe hun ali bɔ miɖe bɔ ɔ mɔ bi	et bons vous ouvrira le chemin et vous cherchez venant ici vous le trouverez
ɖo mɔ jɛ mɛ	estce que comprends
hun nyɛ ɔ wɛ nɔ nyi	donc moi je
bɔ gɔn	et vous êtes venus chez moi
gɔn ɔ gbe mitɔn ɔ ɖo	lorsque vous êtes donc venus chez moi votre venir ici échappera pas
gbɛ ɖo	vous abandonnera pas
sɔ unɖe ganji	que vous prenez faire vous devez le faire
bɔ ku yi gbe bɔ azɔn yi gbe	et que et maladie vous emportent
hun bɔ gbɛmɛ ɖi	donc et votre durera
bɔ wɛ danxomɛ mitɔn tɔn sɔ xlɛ	et qui au du dahomey notre pays ici va montrer
bɔ kpɔn bɔ mɔ jɛ mɛ tɔn	et et que découvres va
ɖɔ xo	estce que comprends
hun niavy towe herman kpodo brisi kpo	donc tes amis herman et brice
xɔntɔn towe lɛ kpo mɛ lɛ	et les autres amis avec qui
vivi wli yɛyi	fait plaisir et ça
bɔ mɛ ɖɔ le	et que
musée hɔn	dans le musée du
glɛlɛ hɔn	dans le palais du
xwegbaja hɔn	dans le palais xwegbaja
byɔ finɛ ɔ mɔ	rentres là
acɔnu ahenu mɔ kpɔn gbeɖe mɔ bi	tous les habits que jamais vus les verras tous
mɔ gbɛtɔ	voir les morts
bɔ ɖo mɔ gbɛtɔ bɔ ɖo	et ils sont debouts verras des têtes morts posées
mɔ mɔ ajajaxu bɔ ɖo vovo	voir des bras des côtes rangées qui seront groupes
bɔ hɛn ɔ kpla bɔ kpɔn bi ɖokpo ɖokpo	et veut va et verras
hun gbe mitɔn ɔ miɖɛ lɛ tɔn mɛ ɔ xwegbaja kasudo wɛ	donc que vous avez voir ici concernant notre pays celui xwegbaja kasudo
emi ɖo ɔ sɔ jɛ nukɔntɔn ɖo	que entends ici peux pas raconter ailleurs
sɔ bɔ yi ɖɔ mitɔn	raconté ailleurs comme vendu notre pays
mɔ nukun jɛ mɛ	estce que compris
hun đe gbɔn ɔ cɛ	donc lorsque viens ici maintenant je remercie
bɔ yi xwe ɔ mɔ xwe ɖo ganji	et rentres trouver maison comme il convient
mɔ vi ɖo ganji	et retrouver les enfants comme il convient
mɔ asi ɖo ganji	et retrouver femme comme il convient
va	va
đo mĭtɔn mɛ ɔ vidomɛgɔn xo ɔ nuɖe wɛ nyi	dans notre pays problème que les enfants frappés
bɔ mɛ lɛ	et ça fait souffrir les
mɛ nɔ ze vi etɔn lɛ mɛ wɛ bɔ nɔ hɛn lɛ ɔ	les qui confient ces enfants à des qui les prennent
bɔn suvan ɔ	souvent
gleta gleta wɛ nɔ gosin kpodo vi etɔn lɛ kpo	ils viennent campagne avec ses enfants
nɔ ze mɛ lɛ ɖɔ nyi hɛn	et viennent les amener à des personnes qui occuperont
bɔn mɛ nɔ mɔ lɛ wɛ	sont des qui déjà ainsi
mɛ ɖo akwɛ hɛn vi yetɔn lɛ	des qui pas élever leurs enfants
ɖo vi gege ɔ	et ils ont déjà beaucoup
wɛ nɔ ze vi lɛ	sont eux qui amènent les enfants
dɔnk nɔ ci ɖi vi lɛ ɖɔhun wɛ mais nɔ ɖɔ emi ă	donc comme vendaient les enfants mais ils disent vendent pas
nɔ ze mɛ lɛ ɖɔ hɛn mɔ nuɖe ze nemi ɖe ji	ils les remettent aux qui veulent occuper trouvent quelque veulent leur donner
dɔnk mɛ lɛ yi vi lɛ mɔ hɛn wɛ sɔ nɔ tɔju vi lɛ ɖi vi yetɔn ɖɔhun normalement ă	donc les prennent les enfants ainsi et occupent ils veillent leurs enfants comme normalement
dɔnk ɖebu ɖe ɖo xwe ɔ gbe bɔ ɔ	donc quoi qui trouve à maison et auront à faire
yeɖɛ lɛ wɛ nɔ zɔn	euxmêmes quon commande
bɔ vi ɖesu tɔn ɖe yi ji ɔ nɔ nuti ă nɔ ɖo xwe ɔ gbe	et leurs propres enfants ont engendrés ils leur rien mais restent rien faire à maison
vi ɖo vi ɖe ze ɖo yi gɔn lɛ ɔ	et ces enfants ont amenés à maison
nɔ bi	ils ont à faire
vi lɛ lɛ yi wu fɔn	et les les enfants donc qui réveillent donc pas rapidement
nɔ xo	ils les tapent
kabi vi ɔ hɛn vɛra gba mɔ kabi hɛn	ou pareillementou tient une bouteille et fait tomber
kpɛɖe kpowun ɔ nɔ xo bɔ agbaza tɔn bi nɔ gble	il fait simplement une il est frappé très jusquà que soit gâté
nɔ danu xa vi lɛ donk nyi nuɖe	et ils sont avec les enfants donc quelque
nyɔ nyɔ ɖebu bɔ	et
jɔ normaleman dɔnk	il passera rien normalement donc
togan ɖo kɛ xo enɛ wu	le ouvrir parler
jɛ wezunkan ji	et rapidement
jɛ ayixa ɖewu ji	et à réfléchir
bɔ tuun ɖee gbɔn ɖo enɛ ɔ kpɛɖe ɔ	et il saura à faire afin que cette cesse peu
đo enɛ ɔ yi nyanya tawun bɔ ɖo ɖe	cette est vraiment devenue une mauvaise et pas maintenant
hɛn vi gege gbɛ gble	va détruire beaucoup
paske ɖo mɔkɔtɔn xa yɔkpɔvu lɛ ɔ	parce que fait ainsi avec les enfants
nɔ hɛn yetɔn mɛ gble bɔ bɔ su ɔ	ça les traumatise grandissent
enɛ nɔ ci mɛ	cette les dans leur tête
bɔ sɔ nɔ yi gbɛtɔ jɔ gbɛtɔ ɖe ɖo yi normaleman	et ils deviennent normalement ça devrait vrais hommes
dɔnk nɔ hɛn vi lɛ gbɛ gble wɛ	donc ils gâtent des enfants
mɛ mɔnkɔtɔn ɖee nɔ yi vi lɛ ɖo nɔ hɛn	ceux aussi qui prennent déjà les enfants dans ces endroits et qui les gardent
nɔ ɖo adaka xo xa wɛ	et commettent des méchancetés extrêmes
ɖo jɛ wli ji	ils doivent être recherchés avec des fusils à être incarcérés
wli mɛ oɖe atɔn mɔ	et quand va le faire avec une deux trois personnes
mɛ kpo lɛ ɔ ɖi xɛsi bɔ sɔ nɔ mɔkɔntɔn	les autres vont avoir peur et feront ainsi
dɔnk xo ɖee nyɛ mɔ ɖɔ ɖo viɖomɛgɔn xo wu ɔ nɛ	donc une histoire que trouvée ces enfants esclaves frappés
axi nɔ ylɔ ɖɔ dantɔkpa	le marché dantokpa
axi ɖaxo ɖe wɛ nyi ɖo kutɔnu	le marché cotonou
ɖo afrika gbeji ɔ bi ɔ elɔ ɖo axi ɖaxo lɛ mɛ	lui aussi est des grands marchés
axi ɔ klo tawun	le marché est vraiment
ɖo tɔ	et il est au du
ɖo ɖo noxwe ɖe	et à il est au du noxwe
wutu wɛ nɔ ylɔ axi ɔ ɖɔ dantɔkpa	pourquoi le marché dantokpa
noxwe ɔ ɔ ɖe ɖo noxwe ɔ	au du noxwe il au
bɔ wɛzɔn bɔ nɔ ylɔ axi ɔ ɖɔ dantɔkpa	pourquoi appelle le marché dantokpa
axi ɔ klo tawun	le marché est très
ɖo axixɔ ɖaxo ɖe ɖo axi ɔ fiɖe tɔ ɖe ɔ kpa	il immeuble à côté là où est le fleuve
bɔ axixɔ etage wɛ	immeuble à étages
etage atɔn mɔ	trois étages comme ça
wɛ axixɔ co ranga ɖaxo ɖokpo lɛ ɖe	il
cobɔ ranga winiwini lɛ ɖo axi ɔ mɛ kpɔ	et il aussi plein petits hangars dans le marché
byɔ axi ɔ mɛ ɔ	rentres dans le marché
ɖebu ɖe ɖe ɔ ɖo gbemɛ ɔ yi mɛ ɔ mɔ xɔ	que cherches dans monde à acheter rentres dans le marché dantokpa trouver
cobɔ nanzeria mɛ lɛ nɔ lɛ bɛ yetɔn lɛ axi ɔ mɛ	et les du nigeria amènent aussi des trucs dans le marché
nɔ yetɔn kpayɔkpayɔ lɛ	et vendent leurs choses piratées
nɔ	et les vendent
ajotɔ lɛ ɖesu ɖo nɔ axi ɔ mɛ	les voleurs aussi viennent au marché
axi ɔ mɛ nyɔ xwe ɖebu wli	rentres au marché contrôles
ja ɖo vɛ nɔ xɔ gbe ja	va voler crois viennent acheter
ja gbe wɛ yi	ils viennent voler
wɛzɔn byɔ axi enɛ ɔ mɛ ɔ	pourquoi rentres dans le marché là
wli hwɛ ɖe	dois soin
wli bɔ akpo towe	soin
bɔ wli aɖɔkɛ towe	soin besace
wli towe	soin
bi ɖo xɔ gbe ja axi ɔ mɛ ɔ	et dois être rapide acheter au marché
axi ɔ mɛ ɔ ɖo sɔ	dans le marché chacun secteur
ɖo sɔ ɖokpo ɖokpo ɖokpo ji ɖe	ils ont leur là
jan xɔ	veux acheter
jan xɔ togbe chaine	veux acheter une boucle une chaine
enɛ lɛ ɔ yi axi ɖaxo ɔ ayixɔ ɖaxo ɔ ɔ	ça là au marché du immeuble
mɔ mɔnkɔntɔn lɛ	trouver ça là
co lɛ yi ranga mɛ ɔ	retournes au
lɛ mɔ mɔnkɔntɔn lɛ	trouver ça là
mɔ ɖokpo ɔ mɔ wɛ ɖe sonusonusonusonu ɖo	même comme ça que ça trouve
axi ɔ mɛ ɔ nɛ axi ɔ klo tawun	dans le marché qui est très
ɖe ɖe ɔ byɔ nɛ mɛ ɔ mɔ ɔ	que veux viens dans marché trouver avant
ji ja ɔ gbɔn axi ɔ mɛ	pleut peux pas dans le marché
bɔ nɔ ylɔ azɔ xwe ɖe ɖɔ sojema	et il une société qui sojema
wɛ nɔ kpe nukun ɖo ɔ wu	qui du marché dantokpa
sojema tike mɔ mairie mɛ lɛ	sojema est partie voir les mairie
bɔ gbɔn axi ɔ mɛ fiɖe ɛ	et eux sont venus mettre des pavés dans certains endroits du marché
mɛ fiɖe lɛ kpo ɔ jɛ	mais il reste certains endroits pas fait jusque maintenant
ɖo byɔbyɔ ɔ sojema mɛ lɛ wɛ mɔ mairie tɛn kpɔn kpo lɛ ɔ mɛ ɔ	je demande à que les sojema aillent voir les mairie puissent le reste du dans le marché
ɖo ɔ axi ɔ ci axi ɖaxo axi wɛ	parce que le marché ressemble à marché
ðo ɔ mɛ	parce que le
mɛ nutɛ kpo bɔ mɔ enɛ ɔ mɛ	les que cherches et que pas trouver dans le marché
ɖe ɔ axi ɖaxo ɖokpo wɛ nyi klewun mɛ ɔ	pas le marché dantokpa est marché résumer
ɖo ɖɔ ɖo ɔ wu enɛ	que à le marché dantokpa
edabɔ	au revoir
ðo kutɔnu ɔ ɖa wɔ ɖo alɔkpa	cotonou quand prépare pâte fait différentes façons
mɔ atɔn mɔ bɔ nɔ ɖo ɖa wɔ	deux ou trois façons préparer pâte
nyi ɖɔ etɛ	voici procède
co ɖa wɔ	avant que prépares pâte
ɖo mɔ linfin gbade linfin mɔ	trouver farine farine maïs et trouver
wɔ ɔ ɖatin asikɛ kpo gannu lɛ kpo	remuer pâte avec les bols
ze wɔɖazɛn ɔ ji	prendras à pâte et mettras le
flɔ myɔ	et allumeras le
ze wɔɖazɛn ɔ	et mettras pâte le
ɖo wɔɖazɛn ɔ mɛ	et prendras dans à pâte
mɛɖe lɛ nɔ linfin ɔ ɖo	certains versent pluie farine dedans
bɔ ɖazɛn ɔ mɛ azɔn ɖokpo nɔ	et dans ils remuent même temps
nɔ jɛ dindan ji dɛdɛdɛdɛ bɔ	et commencent remuer doucement
ɔ nɔ hun agban	dans
nɔ kpan	et ça devient bouillie
ɔ hun agban ɔ	et quand bouillie
nɔ ɔ kpo	prends bouillie peu et mets à
nɔ kɔn linfin ɖe mɛ bɔ nɔ bɔ nɔ bɔ nɔ	et verses farine dedans et remues remues
bi fo ɔ	remuer
nɔ kɔn ɔ kɔn ɖe kpo ɔ	liquide verses bouillie que avais retirée et à
lɛ bɔ bɔ bɔ ze hwe cɛju afɔtɔn mɔ	à remuer à remuer et minutes
bɔ	et remue et prend une partie
mɔ ɖokpo ɔ lɛ ja wɔ ɖa gbe ɔ	comme ça veux préparer pâte
nɔ ji bɔ nɔ ɔ ɖo bɔ ɔ nɔ hun agban	leau le laisse et
ɛ nɔ hun linfin bɔ nɔ ɖevo	et jette pluie farine maïs et prend
bɔ nɔ nɔ kɔn ɖo zozo ɔ mɛ	et mélange bouillie et dans chaude
bɔ nɔ	et fait bouillie avec
bɔ hun agban	et
ɔ hun agban nɔ kpo bɔ nɔ lɛ ɖa	bouillie prend peu et à et recuit
bɔ nɔ linfin ɖe mɛ bɔ nɔ ɖa	et jette farine dedans et prépare
ɖo alɔkpa mɔ ji bɔ nɔ ɖa ɔ	il deux façons préparer avec
bi fo ɔ ɖo gannu mɛ gannu mɛ	et ça finit cuire vous allez ramasser ça dans le bol dans le bol
bɔ wɔ enɛ ɔ hɛn ɔ nɔ ɖu wɔ kpodo nusunnu kpo nusunnu ɖebu nɛnuwi mɛ	et cette pâte peut avec quelle exemple gluante
fevi wɛ	gluante au gombo
wɛ jro bɔ ɖu	légumes qui plaira avec
nusunnu wɛ jro bɔ ɖu	tomates que plairas avec
nusunnu ɖebu	quelle
wɛ nɔ ɖu wɔ ɔ	pâte avec
mɛ wɛ	qui
nyɛ wɛ	moi
nyi leonrasta	moi léonrasta
nɛ gbɔn	est le pays
mɔ ɖé ɖo jija wɛ ɔ	vu pluie qui
ji ɖo ji ja wɛ elɔ lɛ mɛ ɔ ji ɔ nyɔ ɖébu ă	pluie qui pas
ji ɔ nɔ ja é nɔ ja vɔn mɛ bi é gblé	pluie dans les basfonds est gâté
ɖo ali ɔ ji	il leau
ɛɛn tlɛ jawé xwé gbé lɔ ɔ tlɛ tuun à gbɔn mɛ jɛn gbɔn	oui essaies venir à maison tentes savoir où mais dois dans leau
ɖo ɖé gbɔn bɔ gɔ gbɔn mɛ mɛ jɛ gbɔn	peux faire autrement dois seulement dans leau
ɛɛn ji ɔ ɖo ji ja é nɔ ja nɔ kɛn nɔ ja nɔ kɛn nɔ ja nɔ kɛn	oui pluie puis ça sarrête et ça et sarrête
jlo é ɔ é nɔ ɖo é jlo é é nɔ ɖo ă nɔ ja mɔ tɔn	veut ça veut pas ça pas et ça vient ainsi
mɛ lɛ nɔ yi azɔmɛ mɔ tɔn mɔ tɔn tuun tuwun ɖé é gbɔn nɛ	les vont au ainsi sait pas sais pas va faire
ɛɛn mɔ mɔ ɖɔhun é ɖo ji ɔ wutu ɔ	oui ainsi que je vu il pleut
mɛ ɖé lɛ nɔ yi azɔmɛ mɛ ɖé lɛ nɔ zɔn mɛ nɔ yi azɔ mɛ	il des qui vont au il des qui circulent sous pluie au
mɛ ɖé lɛ nɔ ci xɔ mɛ	il des qui restent à maison
azizɔnnɔ sixu byɔ ji enɛ mɛ nɛ	celui qui est malade peut pas rentrer dans cette pluie
ahan	ok
enɛ ɖo ploblɛmu ɖebu ă	pas problème
nyɔ sé à	compris
ɖɔ ɖɔ jre bɔ flin	avant que vous vous le rappeler
ɖɔ ɖɔ je ke ɖo kutɔnu ɔ ji bɛ ɔ	déjà avant que à cotonou pluie
kutɔnu ɔ kun nɔ nyɔ kpɔn	alors cotonou pas à
tɔ nɔ gbɔn bi bɔ ɔ gbɔn bi	il rivière partout et partout
ɖi ɖe kɔ ɖɔ gbɔn ɔ mɔ ɖokpo ɔ ɖo kutɔnu ɔ	comme je avant même ici à cotonou
mɔto sukpɔ kɛkɛ zokɛkɛ sukpɔ tawun	les voitures sont pas nombreuses les vélos les motos sont nombreux
bɔ zemijan zokɛkɛ nɔ sɔ mɛ ɖi ɖɔhun	et le zemijan est une mototaxi
bɔ nɔ ylɔ ɖɔ zemijan	et les appelle zemijan
zemijan lɛ sukpɔ tellement ke kutɔnu ɔ sukpɔ	les zemijan sont tellement nombreux que ça crée plein à cotonou
bɔ jonɔ lɛ mɛ gosin exterieur	et les étrangers qui viennent
gosin yovotɔmɛ fiɖe fiɖe	et viennent partout
kutɔnu ɔ	et viennent à cotonou
nɔ mɔ ɖɔ jre ke kutɔnu ɔ ɖe tawun bɔ ɖesu nɔ ɖɔ	ils trouvent cotonou est et euxmêmes le disent
adigban wɛ ɔ gosin	mensonge pars
wli ali bɔ xwe nyi gbe ganxi	et fais comme celui qui va à ganxi
mɔ ɔ bɔ lɛ wu xwe towe bɔ sɔ	comme ça prends à maison et correctement
bɔ xa kɛkɛ ji yi bɔ lɛ kɔ bɔ ze abi coton	et prends mototaxi montes moto ça et là et reviens et prends ou du coton
sunsun nukɔn mɛ mɔ ɖɔ jre ke poussiere nɔ gɔ coton ɔ mɛ	et voir que poussière est pleine dans le coton
enɛ wutu ɔ ɖo kutɔnu	cela que est omniprésente à cotonou
bɔ enɛ ɔ bɔ jɛ wɛ nɔ ɖe	et ça
bɔ nɔ wu ɖo azɔn jɛ wɛ	pourquoi tombons malades
yi dotoxwe ɔ gbɛtɔ nɔ yawu ɖo xwe nabiɖe bɔ nɔ ku	à les meurent rapidement à quel âge
bɔ nɔ ɖo xwe au moins kanɖe mɔ	ils ont au moins ans
bɔ gbɛtɔ ku enɛ azizɔ enɛ lɛ gbɔn ɖo gbɔn ɖɔ xo mɛ miɖe lɛ	et va mourir à et fumée dans ventre
nɔ hɛn azɔn winiwiniwini kpla ɖo ɔ afrika	cela qui amène petites maladies afrique
enɛ wutu ɔ ɖo ɖo ɖiɖɔ gouvernement wɛ	cela fait appel au gouvernement et lui
ɖɔ kpɔn xo ɔ wu ɖo ali lɛ ɖo	regarde les problèmes et refait les chemins
ɖo gbɔn bi	il des trous partout
zemijan lɛ ɖesu sukpɔ	les zemijan aussi sont nombreux
bɔ nɔ ɖe hwebinu	et tous les il des accidents
azan nɛ bi ɖi ɛ ɔ ku mitɔn mɛ jɔ ɖe kɛkɛ ɖe bla ɖe	fois passée devant entre deux motos
bɔ mɛ wɛ lɛ bi yi kɔ mɛ	et tous les deux sont terre
wɛ nyɔ bɔ mɛ ɖokpo mɛ ɖokpo eyɛ ɔ hun gba gbe gbɔn bi	peutêtre est mais le partout tête
wɛ nyɔ bɔ mɔ mawu xwlɛn	peutêtre ils auraont ils seront dieu va les sauver
ze yi dotoxwe ɔ	les amène à
mawu xwlɛn bɔ ci ðo jesuschristus kɔ mɛ	dieu va les sauver et ils rien dans le nom jésuschrist
jan yi	veux
ɔ	jaco
gosin kɛndonu yi dɔn ɔ	et viens kendonu làbas
gosin kɛndonu ɖo zemijan ɔ	et viens kendonu et prend zemijan
ze ɔ drowa	le pavé
jɛ mɛnotɛn	et arriveras à menotin
jɛ mɛnotɛn jɛ ɔ	commences menotin arriveras au
kuhunu lɛ vɔ ze	kouhounou et prends nouveau
ɖo yiyi ɔ jɛ kasse oto	et continues au casseautos
jɛ kasseoto ɔ	arrives au casseautos
kɔntinwe jɛ akosombo	continueras à akosombo
gosin akosombo ɔ	viens akosombo
ze ɖe	prends le pavé
enɛ ɔ trele ɔ yi jɛ bayiɛ	et aussitôt du pavé arriverons à barrière
jɛ barrie ɔ	quand arrives à barrière
lɛ kɔntinwe yi jɛ gbedegbe	continues à nouveau que arrives à gbedegbe
zɛ gbedegbe wu ɔ	dépasses bifurques gbedegbe
yi jɛ fiɖe rayi klan ali ɔ ɖee ɔ finɛ wɛ	débouches à où les rails séparent qui est là
nɔ ylɔ ɖɔ ajaha	cet endroit adjaha
jɛ ajaha ɔ	et maintenant arrives à ajaha
mɔ fijrose ɖee yi ɔ	trouver les pavés fidjrosse qui conduisent à
dɔnk ze enɛ ɔ jɛ fijrosse kalver	donc prends les pavés arrives à fijrosse calvaire
finɛ mawu ɖo jezu	là fait dieu fait
ɖo jezu nyɛ akluzu ji ɖo finɛ	il donc croix jésus là
finɛ wɛ nɔ ylɔ ɖɔ kalver	là calvaire
jɔ finɛ ɖo ɔ	arrivé là
lɛ kɔntinwe jɛ hwenusu	continues à nouveau arrives à hwenoussou
hwenusu ɔ karefur ɖaxo ɖe wɛ	hwenoussou est carrefour
stasiɔn desanz ɖe lɛ vɔ ɖo finɛ	une aboutit là
bɔ zemijan lɛ nɔ kɛkɛ ɖo finɛ gege	les zemijans qui garent leurs motos là sont nombreux
lɛ jɔ yeɖee ɖo lɛ vɔ kɔntinwe	arrives à nouveau
dɔnk jɔ eɖee ɖo ze ɔ drwa ɔ	donc arrives les pavés
ɖo yiyi wɛ ɔ yi jɛ ɔ	arrives à
jɛ ɔ finɛ ɔ	arrivé à à
ali vɔvɔ ɖokpo lɛ vɔ yi trele	il aussitôt une autre voie terre
ze jro wɛ	envie prends
lɛ vɔ kɔntinwe ɔ	continues à nouveau
lɛ ze ali vɔvɔ enɛ ɔ	reprends le chemin
yi	iras euh
nɛ pisin ɖe ɖo nukɔn dɔn	une une devant làbas
wɔn pisin ɔ nyikɔ	oublié le nom
togbɛn wala nɔ ylɔ ɔ ɖo togbin	togbin voilà togbin
dɔnk jro	donc et veux
bɔ lɛ ɔ	et continues à nouveau
ɖi ɖɔ togbin ɖi km kabi km mɔ	je pense que ça faire ou km
dɔnk zɔnlin ɖi ɔ jlɔ ɖi zɔnlin	donc ou veux
kabi jro ɖo kɛkɛ	ou prends taximoto
yi togbin	et iras à togbin
jɛ dɔn ɔ	arrives làbas
mɔ mɛ lɛ nɔ su kpɔ	trouves beaucoup
bɔ nɔ ɖo pisin mɛ finɛ nɔ ɖo wu lɛ	ils sont à et lavent
enɛ ɔ lɛ bi bɔn	tous
jrɔ bɔ ɖi ɔ	veux promener
hɛn yi finɛ	peux là
nɔ	soit à jaco
byɛn kɔntinwe sɔ yi togbɛn	ou continues togbin
mɛ atansiɔn kpɛɖɛ	mais dois faire peu
ɖo kɛkɛ ɖido ɖo elɔ mɛ ɔ	aux conducteurs moto qui rendent là où il des
nɔ polusiɔn nɔ su kpɔ	il beaucoup
ɖɔnk kɛkɛ ɖe nɔ ɖo azizɔ ɖe tɔn ɖokpo bɔ	donc les motos rejettent tellement fumée
elɔ ɖe bɔ	cherches quelque
nɔ nuɖe lɛ ɖo mɛ ɖo	quelque vendent aux feux tricolores
bɔ nɔ ze su awɔntin	couvrir le nez avec
ɖɔnk xɔ enɛ ɔ ɖokpo	donc achètes
ze bla awɔntin twe enɛ ɔ	que à nez
fime sɔ bi ɔ awɔntin twe mɛ	fumée va rentrer dans nez
ɖo azizɔ lɛ nɔ su kpɔ	il trop fumée
bɔ fwa ɔ ali ɔ ɖesu nɔ ɖo ankɔnbre	et des fois voie aussi est encombrée
bɔ mɛ lɛ nɔ su kpɔ	et les sont nombreux
atansiɔn	fais
nɔ xwii ɖo kɛkɛ ɔ ji bɔ yi jɛ ɔ	tranquille moto